census_block_group,B12001e1,B12001m1,B12001e2,B12001m2,B12001e3,B12001m3,B12001e4,B12001m4,B12001e5,B12001m5,B12001e6,B12001m6,B12001e7,B12001m7,B12001e8,B12001m8,B12001e9,B12001m9,B12001e10,B12001m10,B12001e11,B12001m11,B12001e12,B12001m12,B12001e13,B12001m13,B12001e14,B12001m14,B12001e15,B12001m15,B12001e16,B12001m16,B12001e17,B12001m17,B12001e18,B12001m18,B12001e19,B12001m19
1001,44749,9134,21393,5286,6448,3499,12485,3503,11825,3431,660,806,182,486,478,686,433,697,2027,1701,23356,5419,5912,3275,12270,3480,11557,3343,713,975,426,761,287,591,2177,1763,2997,2149
1003,174821,37004,84252,21821,23592,13672,47665,13199,44219,12395,3446,4161,1218,2353,2228,3280,2888,3341,10107,7669,90569,22098,19612,11926,47694,13263,43339,12117,4355,4818,2376,3352,1979,2887,9805,7165,13458,8702
1005,20968,4377,11230,2872,4508,1860,4879,1664,4056,1408,823,689,327,461,496,523,374,477,1469,815,9738,2362,2930,1533,4458,1378,3970,1284,488,526,337,431,151,308,1302,810,1048,739
1007,18827,5322,10147,3163,4035,1960,4162,1707,3617,1585,545,569,293,446,252,309,398,453,1552,1275,8680,3051,2316,1664,3880,1569,3479,1521,401,472,223,362,178,334,1224,994,1260,1116
1009,46625,11055,22919,6450,5915,3340,13186,3960,12028,3768,1158,1240,406,728,752,955,1025,1200,2793,2098,23706,6154,3972,2622,14263,4228,13023,4000,1240,1341,454,770,786,985,2667,1921,2804,2063
1011,8514,2702,4712,1732,2364,1291,1956,907,1728,870,228,265,135,211,93,158,31,87,361,386,3802,1347,1587,977,1350,699,1139,586,211,296,146,211,65,167,536,424,329,299
1013,16184,4110,7294,2432,3079,1819,3343,1248,2935,1102,408,524,220,386,188,349,152,265,720,659,8890,2473,2796,1573,3905,1386,3367,1217,538,616,269,391,269,466,1129,776,1060,783
1015,94242,23490,44809,13432,14369,8329,23398,8105,21388,7405,2010,2732,989,1884,1021,1936,1486,2076,5556,4690,49433,13944,12889,7784,24316,8391,21907,7660,2409,2832,1633,2261,776,1740,5598,4209,6630,4888
1017,27796,7308,13205,4306,4546,2784,6595,2577,5722,2354,873,993,333,660,540,767,498,736,1566,1333,14591,4365,4247,2624,6383,2486,5667,2326,716,870,464,685,252,550,1986,1458,1975,1517
1019,21773,5056,10683,2849,2536,1551,6548,2124,6189,2073,359,516,137,334,222,422,466,568,1133,868,11090,2867,1816,1261,6554,2085,6128,2005,426,509,234,399,192,359,1211,863,1509,1070
1021,35414,8954,17289,5297,5230,3205,9057,3142,8433,3036,624,834,115,433,509,760,710,909,2292,1986,18125,5122,3796,2619,9660,3357,8830,3188,830,1073,464,798,366,639,2067,1592,2602,2077
1023,10819,2989,5074,1710,1480,972,2596,989,2393,956,203,336,62,220,141,290,221,316,777,674,5745,1768,1468,915,2906,1110,2205,897,701,616,400,412,301,397,737,583,634,547
1025,19858,5309,9253,2933,3161,2012,4935,1904,4269,1700,666,842,286,523,380,643,345,523,812,831,10605,3468,3423,2290,4751,1856,4136,1625,615,750,418,587,197,436,1245,982,1186,984
1027,11010,3048,5265,1698,1289,890,3165,1171,2856,1082,309,372,122,226,187,296,209,273,602,568,5745,1800,1219,884,3123,1188,2726,1088,397,413,302,374,95,185,731,550,672,567
1029,12117,2498,5917,1493,1538,793,3445,1002,3288,956,157,223,134,209,23,139,237,300,697,493,6200,1426,957,675,3680,1007,3293,931,387,370,248,318,139,257,879,496,684,507
1031,41515,7161,20267,4173,5837,2570,11213,2662,10261,2467,952,886,496,656,456,595,693,687,2524,1537,21248,4232,4370,2217,11744,2753,10437,2528,1307,1103,706,753,601,750,2132,1245,3002,1687
1033,45253,10499,21395,6095,6205,3900,11906,3842,11296,3659,610,1020,240,729,370,832,716,1004,2568,2133,23858,6212,5139,3484,12499,3930,11513,3729,986,1268,610,1003,376,853,2995,2176,3225,2383
1035,10250,2736,4823,1670,1867,1150,2248,986,2017,939,231,304,131,243,100,203,407,465,301,327,5427,1655,1757,1017,2263,1003,1910,896,353,398,179,242,174,304,915,717,492,463
1037,9288,2475,4674,1494,1531,802,2276,933,2096,872,180,246,127,226,53,152,199,286,668,529,4614,1494,1086,807,2409,945,2166,880,243,320,149,248,94,198,659,544,460,454
1039,30468,7144,14466,4168,3741,2309,8124,2616,7483,2413,641,866,261,611,380,690,711,868,1890,1453,16002,4135,3452,2198,8091,2521,7345,2366,746,857,489,715,257,548,2311,1450,2148,1491
1041,11289,1919,5434,1158,1861,837,2737,674,2399,629,338,302,102,149,236,239,193,181,643,425,5855,1146,1460,673,2855,687,2510,631,345,299,219,246,126,177,845,428,695,410
1043,67408,17488,33028,10094,8467,5549,18753,6392,17340,5934,1413,1970,550,1166,863,1550,1055,1569,4753,3664,34380,9761,6388,4815,18899,6451,17184,5958,1715,2100,920,1494,795,1468,4536,3155,4557,3510
1045,39789,9289,19455,5486,5950,3377,10251,3430,9050,3099,1201,1319,238,625,963,1230,643,843,2611,1914,20334,5523,4542,3102,10285,3488,9053,3076,1232,1331,604,899,628,985,2355,1638,3152,2125
1047,31436,8534,14159,4756,5821,3273,6386,2802,5687,2639,699,942,478,817,221,590,562,799,1390,1275,17277,5466,6611,3805,6810,2731,5605,2487,1205,1223,769,934,436,738,1956,1540,1900,1508
1049,56984,15216,27930,8725,7980,5125,15656,5431,14559,5102,1097,1471,490,966,607,1117,870,1247,3424,2714,29054,8537,6236,4338,15930,5422,14484,5061,1446,1712,790,1193,656,1109,3456,2756,3432,2604
1051,66194,14091,31638,7852,9992,4832,16454,4825,15420,4691,1034,1070,322,797,712,846,870,1193,4322,3073,34556,8579,8124,4818,19043,5787,17530,5478,1513,1713,698,1135,815,1174,3339,2583,4050,2797
1053,30194,7145,15394,4360,6228,2980,6754,2429,5885,2152,869,887,352,633,517,620,427,613,1985,1438,14800,4168,4082,2567,6513,2318,5916,2173,597,774,285,515,312,607,2154,1478,2051,1524
1055,84604,19716,40314,12110,12525,7831,20439,6736,18874,6219,1565,2271,635,1480,930,1829,1779,2214,5571,4529,44290,11760,11139,6821,21156,6965,18971,6241,2185,2715,1211,1920,974,1852,5389,3714,6606,4783
1057,13629,3394,6550,1978,1460,991,3968,1351,3727,1286,241,383,115,311,126,269,285,324,837,734,7079,1969,1192,901,4214,1376,3785,1298,429,501,307,417,122,271,889,622,784,670
1059,24939,7172,12336,4340,3707,2480,6548,2603,5953,2302,595,844,39,305,556,830,427,659,1654,1423,12603,4005,2906,2102,6298,2343,5602,2128,696,829,436,660,260,506,1602,1130,1797,1466
1061,21640,5785,10421,3125,2681,1608,5812,2127,5316,2019,496,631,243,442,253,511,452,565,1476,1110,11219,3357,2178,1503,5837,2135,5387,2026,450,524,370,484,80,287,1497,1114,1707,1200
1063,6770,2555,3000,1456,1441,1078,1158,746,988,691,170,254,114,215,56,176,190,301,211,270,3770,1655,1682,1158,1140,725,775,525,365,406,338,373,27,140,594,587,354,346
1065,11964,3170,5552,1881,2144,1327,2709,997,2549,942,160,264,146,259,14,161,125,223,574,465,6412,1854,2389,1215,2505,902,2290,856,215,267,120,206,95,218,749,477,769,518
1067,14191,2804,6776,1668,2089,1140,3985,1085,3593,1006,392,456,171,285,221,367,207,270,495,447,7415,1675,1629,997,4052,1119,3682,1068,370,410,211,294,159,298,917,567,817,652
1069,84694,11164,39815,6590,13421,4484,20215,3613,18450,3205,1765,1452,703,847,1062,1143,1356,1065,4823,2222,44879,6704,12176,4060,20753,3604,18544,3207,2209,1492,1362,1131,847,944,5043,1989,6907,2570
1071,42897,10662,20658,5888,5193,3274,12011,3986,11411,3903,600,855,196,547,404,775,681,905,2773,2164,22239,6338,3958,2945,12532,4341,11542,3973,990,1282,658,1007,332,790,3043,2214,2706,2024
1073,533380,131351,247724,77138,90984,52847,121801,43723,110581,39791,11220,15005,5531,10984,5689,10688,7195,11474,27744,24343,285656,79692,93995,51382,123875,43586,110681,39739,13194,16082,7558,12191,5636,10591,28279,22473,39507,28611
1075,11379,3445,5480,1910,1126,837,3498,1441,3260,1373,238,366,131,273,107,261,306,425,550,511,5899,1903,1172,837,3143,1306,3062,1290,81,216,56,187,25,193,897,598,687,571
1077,77549,18365,36703,10964,10283,7066,20913,6817,19587,6522,1326,1840,618,1322,708,1403,1422,1840,4085,3517,40846,10915,10073,6181,20678,6718,19444,6385,1234,1777,432,1110,802,1517,4916,3483,5179,3983
1079,27073,7231,13007,4315,3363,2473,7466,2699,7067,2613,399,634,110,378,289,590,282,540,1896,1665,14066,4122,3022,2178,7959,2836,7197,2653,762,854,480,663,282,564,1540,1238,1545,1292
1081,132430,28944,64706,18091,27922,13619,29842,9048,27963,8550,1879,2559,776,1722,1103,1924,1468,2180,5474,4665,67724,17911,24488,12107,31144,9431,28206,8595,2938,3499,1558,2475,1380,2277,4423,3728,7669,5617
1083,77263,15718,38547,9500,12614,6340,20669,5409,18896,4946,1773,1757,617,1051,1156,1400,978,1205,4286,3222,38716,9067,9100,5077,20372,5565,18556,4926,1816,2040,737,1204,1079,1460,4039,2715,5205,3563
1085,8226,1971,3893,1197,1671,807,1599,675,1423,639,176,247,59,153,117,209,116,187,507,440,4333,1153,1478,694,1700,676,1280,585,420,340,229,274,191,268,605,403,550,384
1087,16050,3174,7239,1895,3421,1438,2708,999,2439,934,269,322,128,258,141,269,177,262,933,636,8811,2032,4100,1565,2914,1043,2520,975,394,377,268,321,126,220,871,610,926,641
1089,296653,53618,143514,32724,48056,22924,77924,20123,72679,18879,5245,6100,2168,4004,3077,4671,3130,4440,14404,10966,153139,32761,42721,21422,77455,19960,71936,18767,5519,6521,2995,4817,2524,4256,12722,9191,20241,12957
1091,15699,5594,7307,3214,2702,2103,3372,1626,2877,1451,495,695,319,561,176,449,486,635,747,891,8392,3525,2856,1994,3166,1557,2701,1420,465,640,209,447,256,478,1336,1203,1034,1011
1093,24773,6588,12100,3886,2980,1944,6970,2728,6319,2455,651,910,223,542,428,714,662,762,1488,1261,12673,3947,2317,1715,6671,2580,6147,2420,524,721,217,472,307,568,1962,1447,1723,1373
1095,75778,16587,36988,9937,10505,5963,20667,6007,19567,5790,1100,1393,400,952,700,1133,1096,1354,4720,3405,38790,9305,8273,4750,20863,5973,19234,5725,1629,1762,1002,1395,627,1083,4725,3154,4929,3185
1097,333044,73776,156449,43937,57465,30260,75855,24176,69237,22254,6618,8335,3327,5906,3291,5838,4973,6574,18156,14315,176595,44660,54826,28633,78036,24029,68413,21804,9623,10008,5210,7089,4413,6643,19172,13463,24561,16392
1099,17429,5051,8066,2939,3235,2200,3621,1508,3322,1395,299,513,188,404,111,344,340,471,870,932,9363,3085,2796,1875,4290,1747,3672,1568,618,730,326,456,292,522,1286,1046,991,896
1101,182244,46763,84487,28219,35087,20599,37898,14446,33516,12820,4382,5679,2301,4324,2081,3920,2304,3898,9198,8218,97757,28750,36567,20581,38510,14468,33755,12768,4755,5901,3021,4809,1734,3564,8519,7398,14161,10230
1103,96776,21711,47143,13088,14297,8545,25915,7828,24346,7493,1569,2089,606,1453,963,1597,1671,2105,5260,4359,49633,12409,11264,7066,26137,7910,23612,7239,2525,2831,1428,2083,1097,1796,5273,3679,6959,4881
1105,7681,3369,3572,2035,2090,1552,863,764,748,713,115,240,50,200,65,184,87,236,532,535,4109,1922,2039,1432,877,749,746,662,131,268,95,257,36,167,721,686,472,578
1107,16964,3987,7902,2473,2625,1546,4047,1491,3755,1444,292,372,183,316,109,260,248,311,982,806,9062,2206,2673,1292,4249,1421,3270,1281,979,512,543,430,436,379,1174,773,966,624
1109,27884,7160,13134,4438,6145,3400,5112,1963,4545,1732,567,676,338,504,229,410,341,427,1536,1272,14750,4295,6959,3171,5085,1900,4594,1744,491,622,148,299,343,571,1400,1110,1306,1062
1111,18624,4300,8984,2448,2899,1724,4809,1606,4437,1507,372,460,107,291,265,388,374,440,902,799,9640,2638,2374,1467,4820,1621,4227,1434,593,624,227,364,366,480,1310,974,1136,866
1113,45976,11000,21832,6520,7169,4205,11397,3794,10361,3587,1036,1245,532,906,504,835,520,772,2746,2288,24144,6533,7255,4174,11243,3878,9740,3394,1503,1658,800,1122,703,1066,2174,1786,3472,2446
1115,71371,14832,35379,8331,9323,4660,20779,5903,18971,5417,1808,2054,934,1420,874,1189,1027,1259,4250,2949,35992,8729,6923,4399,20429,5668,19347,5456,1082,1395,685,1097,397,828,3780,2722,4860,3230
1117,172098,30466,82456,18348,22849,11988,51070,11608,48390,11038,2680,3541,893,2133,1787,2828,1739,2531,6798,5409,89642,18099,21144,10919,50453,11304,47577,10728,2876,3547,1153,2197,1723,2910,7064,5142,10981,6854
1119,10763,3357,4896,2056,2640,1583,1626,880,1383,821,243,311,113,218,130,243,259,358,371,399,5867,2098,2557,1425,1849,985,1441,851,408,483,276,363,132,276,718,622,743,628
1121,66349,15708,31782,9143,10897,5899,15728,5396,13842,4856,1886,1858,1016,1450,870,1187,1377,1631,3780,2936,34567,9425,9878,5747,15988,5476,14412,5022,1576,1839,1103,1515,473,1030,4001,3050,4700,3252
1123,33552,9056,16049,5322,4665,3202,8910,3184,8184,3047,726,972,297,639,429,773,481,783,1993,1663,17503,5254,4364,2841,9017,3297,8306,3114,711,901,309,579,402,734,2108,1782,2014,1667
1125,170932,37736,81435,23434,36121,17813,36312,11436,32905,9963,3407,4479,1223,2552,2184,3498,1611,2498,7391,6219,89497,22802,35268,16602,37286,11424,33915,10397,3371,4135,1725,2939,1646,2812,6881,5220,10062,7182
1127,52383,13360,25390,7783,6740,4424,14195,4894,13238,4724,957,1333,563,1067,394,936,1163,1428,3292,2669,26993,7628,5366,3596,14301,4925,12919,4638,1382,1663,828,1293,554,1075,3820,2432,3506,2722
1129,13738,4087,6735,2399,1981,1405,3630,1463,3422,1400,208,352,47,234,161,324,269,408,855,800,7003,2366,1860,1297,3380,1395,3068,1281,312,429,119,277,193,371,865,716,898,826
1131,8610,2269,4032,1261,1776,908,1575,679,1308,598,267,311,192,283,75,164,256,284,425,376,4578,1370,2023,976,1614,696,1286,586,328,337,235,287,93,193,567,383,374,333
1133,19759,5064,9696,3061,2328,1501,5454,1887,5146,1815,308,463,164,373,144,345,296,449,1618,1401,10063,2836,1896,1371,5404,1879,5061,1775,343,550,258,489,85,317,1240,862,1523,1083
2013,2993,471,1807,346,805,211,783,178,378,77,405,167,46,38,359,162,54,32,165,99,1186,235,398,115,594,160,354,75,240,143,41,33,199,138,107,53,87,58
2016,4832,529,2942,422,1134,255,1468,261,664,120,804,262,40,27,764,255,39,40,301,123,1890,211,564,146,888,151,663,109,225,105,40,28,185,101,176,67,262,90
2020,233097,59952,118724,36843,45878,25848,58907,20433,52664,18678,6243,7298,1869,3843,4374,5770,2326,4097,11613,10666,114373,32962,34504,20035,58138,20114,52659,18645,5479,6652,2300,4211,3179,4716,6074,6755,15657,12419
2050,12743,1968,6725,1266,3570,782,2651,745,2051,441,600,545,134,125,466,518,100,110,404,270,6018,988,2665,655,2617,676,2143,442,474,441,215,193,259,349,391,189,345,240
2060,736,81,452,56,149,40,227,61,158,38,69,62,9,16,60,61,19,16,57,25,284,42,62,19,162,42,137,32,25,38,6,15,19,38,24,18,36,23
2068,2041,542,1068,221,472,257,433,100,285,121,148,110,60,103,88,81,6,10,157,84,973,369,322,83,566,391,270,133,296,483,13,24,283,486,28,27,57,39
2070,3655,682,1920,408,930,213,813,305,602,157,211,254,40,43,171,250,57,45,120,64,1735,391,683,197,785,294,581,137,204,259,59,56,145,243,110,67,157,90
2090,78422,19627,42795,12264,16707,8202,21362,7394,19062,6866,2300,2307,647,1196,1653,1857,590,1139,4136,3646,35627,10429,9290,5811,20328,7104,18716,6694,1612,2001,423,982,1189,1684,1532,1909,4477,3743
2100,1937,528,1016,291,212,138,602,211,574,205,28,35,4,27,24,35,46,72,156,114,921,294,140,92,558,213,533,200,25,61,10,28,15,55,117,117,106,88
2105,1851,321,1027,205,374,128,465,119,355,83,110,91,19,35,91,85,43,34,145,86,824,163,212,85,384,116,329,86,55,63,14,33,41,57,67,53,161,100
2110,26492,5594,13533,3496,4458,2252,7307,2233,6620,2115,687,768,234,413,453,565,283,441,1485,1065,12959,3284,3761,1983,6561,1991,5911,1903,650,745,267,435,383,504,947,864,1690,1263
2122,47487,8564,24871,5325,8369,3684,12678,3260,11444,2955,1234,1180,283,569,951,999,793,858,3031,1848,22616,4903,5283,2741,12292,3213,10926,2853,1366,1370,540,796,826,968,1755,1313,3286,1968
2130,11309,1360,5838,880,2021,605,2960,579,2734,550,226,220,59,138,167,190,133,164,724,362,5471,785,1440,480,2783,539,2527,513,256,199,84,130,172,171,391,244,857,366
2150,10528,1934,5632,1272,2358,887,2761,801,2227,668,534,460,57,122,477,426,81,155,432,343,4896,1071,1163,610,2998,816,2713,762,285,276,28,97,257,266,227,216,508,421
2158,5384,549,2947,455,1832,289,910,317,657,109,253,291,84,50,169,286,44,35,161,56,2437,284,1311,157,813,184,668,102,145,128,60,36,85,123,213,62,100,56
2164,1127,323,631,181,291,82,248,89,173,65,75,44,7,8,68,42,14,11,78,55,496,166,191,77,213,92,149,59,64,58,15,13,49,55,57,24,35,24
2170,81699,11140,42623,7146,15455,5356,21242,3770,18990,3220,2252,1902,722,873,1530,1592,851,909,5075,2563,39076,6421,10741,4126,20632,3469,18428,3070,2204,1608,691,857,1513,1312,2453,1597,5250,2517
2180,7047,1068,3733,664,1982,394,1348,462,1009,261,339,366,71,69,268,343,100,82,303,171,3314,612,1376,321,1362,337,1144,262,218,187,89,73,129,173,282,144,294,243
2185,7620,1226,4858,904,1813,494,2653,559,779,216,1874,448,50,66,1824,440,58,68,334,178,2762,555,1122,326,1120,303,736,203,384,180,52,63,332,169,195,118,325,142
2188,5363,784,2953,580,1629,423,1021,340,727,200,294,248,95,148,199,170,68,82,235,143,2410,481,1161,324,860,232,698,199,162,126,33,64,129,114,170,94,219,177
2195,2715,550,1449,319,584,230,732,194,685,191,47,61,7,22,40,58,28,32,105,71,1266,299,269,123,655,186,599,175,56,48,30,36,26,31,152,98,190,106
2198,5143,755,2819,491,1038,296,1296,324,1093,269,203,181,46,82,157,169,127,111,358,168,2324,393,625,218,1215,272,1094,261,121,106,45,65,76,90,196,121,288,155
2220,7087,1154,3599,756,1155,468,1924,594,1566,506,358,288,113,156,245,243,154,159,366,239,3488,667,897,349,1798,529,1593,502,205,200,58,118,147,169,239,198,554,303
2230,979,103,554,128,220,49,257,115,164,27,93,119,7,5,86,119,16,9,61,31,425,136,146,70,198,70,143,27,55,78,14,8,41,77,17,9,64,20
2240,5292,875,2993,541,1082,360,1566,383,1315,340,251,152,58,69,193,123,51,68,294,184,2299,469,610,254,1411,341,1265,311,146,132,74,91,72,88,118,96,160,130
2261,7396,1870,3948,1253,1498,835,1705,697,1535,625,170,233,4,88,166,231,67,131,678,576,3448,1126,710,530,2173,767,1920,735,253,333,31,119,222,302,154,209,411,416
2275,2141,372,1166,264,312,142,612,154,549,149,63,61,16,31,47,55,43,55,199,112,975,200,230,123,576,143,527,143,49,44,25,36,24,31,70,48,99,57
2282,513,78,295,52,131,51,132,22,101,23,31,14,8,6,23,13,2,2,30,11,218,37,79,40,98,19,92,17,6,7,0,9,6,7,14,8,27,11
2290,4123,593,2238,465,1222,311,755,327,525,197,230,224,53,59,177,201,76,72,185,133,1885,308,795,186,745,212,624,156,121,127,46,43,75,110,173,90,172,85
4001,55464,10978,27185,6264,13496,4392,10509,3328,8809,2972,1700,1419,566,860,1134,1155,911,939,2269,1637,28279,6671,12737,4424,10333,3271,8615,2928,1718,1358,765,873,953,1056,2477,1462,2732,2078
4003,103049,23942,52390,14318,16388,8312,27079,9042,24120,8341,2959,2718,702,1698,2257,2325,1830,2448,7093,4845,50659,13613,11333,7181,26924,9024,25082,8704,1842,2499,685,1667,1157,2026,5475,4133,6927,4957
4005,117039,27554,57225,16357,27477,12181,23778,8329,21512,7629,2266,2716,505,1475,1761,2374,930,1525,5040,4214,59814,16090,27107,10964,23241,7962,20995,7467,2246,2665,805,1726,1441,2045,3010,2747,6456,4881
4007,44593,10861,21940,6378,5903,3508,11409,3964,10486,3783,923,1236,284,741,639,1020,1110,1230,3518,2483,22653,6245,4931,2963,11565,3970,10676,3903,889,1133,214,670,675,1013,2750,2000,3407,2340
4009,29481,7320,15975,4651,6855,3159,6731,2309,5517,1947,1214,1002,332,586,882,788,447,618,1942,1364,13506,3692,4087,2225,6258,2152,5689,2013,569,714,171,460,398,613,1286,961,1875,1393
4011,7305,1486,3899,988,1338,656,1933,602,1749,562,184,231,93,175,91,141,119,169,509,363,3406,891,848,549,1977,577,1840,563,137,192,10,80,127,196,225,200,356,308
4012,17942,5008,9185,2931,2272,1158,5220,2231,4515,2073,705,793,361,563,344,519,420,491,1273,1116,8757,2805,1732,1106,5045,2157,4479,2027,566,755,204,408,362,585,1061,921,919,799
4013,3461021,742293,1697780,444605,643295,309223,840981,253424,770930,233764,70051,84710,21817,48386,48234,69486,40215,58092,173289,136245,1763241,434962,544279,274316,841331,251788,759413,228826,81918,92414,33539,57757,48379,69943,134640,107352,242991,158810
4015,177774,39272,89621,23185,23680,13666,47775,14810,43261,13478,4514,5123,1978,3156,2536,3555,4474,4701,13692,8794,88153,21871,16939,10603,45930,14090,41248,12771,4682,5218,2023,3199,2659,3737,11764,8104,13520,8734
4017,84796,17036,42290,10033,16349,6347,19373,5868,16659,5243,2714,2446,877,1404,1837,1934,1598,1824,4970,3609,42506,10117,14065,6199,19062,5768,16587,5225,2475,2288,1171,1588,1304,1633,4108,2875,5271,3466
4019,847479,164670,413967,100475,157896,72682,197535,56129,181542,52093,15993,18586,6188,12329,9805,14449,11720,15069,46816,32748,433512,100360,134053,66999,198702,55967,180120,51563,18582,20583,8759,14257,9823,14966,38400,27955,62357,37178
4021,349955,78126,183446,46397,65485,29718,90320,26001,80611,23523,9709,8030,2592,4386,7117,6541,4827,6056,22814,14398,166509,43152,42620,24395,87019,25585,79084,23078,7935,8943,3618,5567,4317,6243,14664,11206,22206,15164
4023,36060,9900,17112,5454,5552,3357,9594,3588,8773,3352,821,1041,315,685,506,794,458,718,1508,1496,18948,5770,5713,3498,9628,3457,8544,3234,1084,1169,625,908,459,723,1444,1345,2163,1774
4025,197126,39026,95595,22899,24186,13239,54133,15170,51272,14467,2861,3841,964,2195,1897,3049,3758,4213,13518,9136,101531,22879,18784,11483,54478,15028,50857,14231,3621,4537,1710,2972,1911,3115,11475,7993,16794,9950
4027,164945,39180,85076,23951,27879,14870,47577,15493,43124,14253,4453,5043,1570,3036,2883,4003,2490,3405,7130,6181,79869,21013,20347,11766,43474,13659,38852,12760,4622,4754,2187,3406,2435,3532,7803,5951,8245,6445
5001,14451,3359,6893,2014,2020,1256,3654,1240,3411,1190,243,402,140,345,103,293,198,310,1021,820,7558,1903,1707,1048,3832,1254,3542,1211,290,434,172,379,118,304,874,673,1145,850
5003,16284,4235,7839,2439,1883,1377,4775,1691,4410,1602,365,509,152,345,213,403,330,457,851,755,8445,2448,1665,1227,4832,1718,4407,1593,425,552,210,409,215,399,1018,756,930,775
5005,35549,7725,17095,4484,3609,2402,10576,3094,10067,2976,509,775,224,539,285,562,792,882,2118,1592,18454,4321,2363,1755,10761,3142,10179,2965,582,810,309,608,273,535,2807,1754,2523,1789
5007,206914,39189,101810,23121,27882,14601,62782,15745,59100,14905,3682,4538,1149,2595,2533,3655,2389,3218,8757,7037,105104,22402,23555,12808,61077,15145,57759,14526,3318,4225,1473,2930,1845,3068,7813,6272,12659,8320
5009,30151,6040,14746,3567,3450,1948,8928,2464,8342,2377,586,711,262,466,324,519,633,683,1735,1366,15405,3511,2752,1672,9062,2542,8539,2418,523,645,337,505,186,391,1581,1151,2010,1375
5011,8690,1967,4110,1191,1200,700,2270,789,2026,714,244,304,145,259,99,205,107,195,533,480,4580,1169,1104,597,2391,798,2097,736,294,315,158,243,136,236,582,397,503,424
5013,4418,884,2236,525,688,368,1054,358,1002,350,52,78,20,54,32,68,83,85,411,271,2182,541,602,356,1057,347,1016,344,41,64,35,62,6,47,229,144,294,228
5015,22952,5494,11315,3062,2652,1599,6951,2230,6397,2091,554,659,344,503,210,359,662,701,1050,912,11637,3080,2289,1457,6701,2172,6364,2093,337,474,168,342,169,314,1026,833,1621,1161
5017,8634,2089,4259,1281,1657,827,1915,795,1652,725,263,283,78,183,185,250,200,235,487,313,4375,1217,1207,714,1986,789,1759,719,227,291,76,172,151,251,615,422,567,428
5019,18855,4574,8776,2657,3557,1771,4213,1443,3889,1369,324,423,172,364,152,286,256,365,750,601,10079,2919,3849,2108,4218,1493,3875,1444,343,404,210,334,133,289,956,649,1056,801
5021,12233,2613,5996,1564,1526,843,3411,1108,3228,1063,183,300,100,269,83,232,258,355,801,559,6237,1488,1213,715,3286,1055,2930,993,356,420,262,409,94,242,997,615,741,587
5023,21155,4657,10406,2675,1942,1317,6467,1856,6133,1800,334,489,112,328,222,406,445,532,1552,1117,10749,2711,1295,1059,6423,1897,5961,1766,462,578,236,442,226,392,1512,1030,1519,1082
5025,6621,1422,3245,781,785,414,1901,581,1756,562,145,174,62,119,83,143,185,212,374,277,3376,849,743,444,1768,579,1683,564,85,111,50,117,35,93,418,263,447,299
5027,19631,3753,9270,2268,3769,1639,4234,1274,3944,1204,290,371,105,204,185,304,483,482,784,612,10361,2254,3531,1599,4399,1284,3720,1153,679,618,392,425,287,361,1294,782,1137,750
5029,16896,3174,8238,1837,2264,1087,4576,1285,4246,1242,330,363,117,228,213,308,368,381,1030,688,8658,1883,1717,890,4982,1407,4294,1230,688,614,311,368,377,424,1075,686,884,618
5031,84925,17297,40705,10341,13596,6615,20664,6292,18902,5825,1762,1978,812,1267,950,1483,1350,1630,5095,3859,44220,10463,12699,6410,20635,6180,18909,5872,1726,1952,929,1457,797,1323,4325,3329,6561,4397
5033,50041,10716,24431,6135,6096,3429,14755,4261,13573,4038,1182,1263,462,741,720,932,789,977,2791,2186,25610,6066,4730,2895,14141,4181,12850,3903,1291,1398,633,935,658,950,3293,2192,3446,2084
5035,37668,8131,17519,5005,6794,3600,8071,2814,7060,2627,1011,1079,585,832,426,706,608,815,2046,1538,20149,4961,6733,3240,8231,2986,6871,2601,1360,1281,988,1097,372,721,2151,1478,3034,1997
5037,13526,3230,6426,1757,1700,1006,3773,1205,3437,1163,336,372,216,320,120,239,250,353,703,614,7100,1896,1420,889,3900,1294,3385,1158,515,558,320,432,195,329,857,612,923,678
5039,6158,1704,2927,956,924,608,1569,626,1347,568,222,253,114,197,108,156,117,154,317,257,3231,1104,919,642,1292,529,1180,477,112,195,100,193,12,107,636,400,384,335
5041,9232,2335,4259,1335,1346,808,2415,917,2198,838,217,283,151,245,66,189,199,256,299,304,4973,1408,1412,871,2478,906,2238,853,240,264,185,258,55,165,606,438,477,426
5043,15080,3965,7164,2338,2339,1498,3966,1532,3756,1523,210,355,107,287,103,292,156,277,703,748,7916,2392,2250,1493,3858,1505,3633,1423,225,367,146,301,79,271,842,698,966,868
5045,99800,18172,48187,11318,17371,8075,24491,6384,22988,6062,1503,1875,875,1403,628,1239,1023,1481,5302,3731,51613,11516,15762,7618,25025,6419,22675,5938,2350,2419,1147,1642,1203,1658,4341,3157,6485,3993
5047,14288,3274,6993,1928,1802,1170,3930,1274,3726,1231,204,319,129,238,75,223,382,416,879,707,7295,2006,1133,792,4135,1415,3633,1275,502,584,160,310,342,439,960,743,1067,750
5049,10183,2753,5056,1620,1031,636,2797,1039,2627,1009,170,238,73,176,97,183,224,307,1004,759,5127,1450,639,466,2852,1078,2740,1072,112,169,42,146,70,163,977,677,659,534
5051,82173,20800,38972,11965,11097,7192,20693,7405,18886,6774,1807,2473,821,1659,986,1746,1601,2041,5581,4735,43201,12579,9610,6735,20827,7470,18806,6796,2021,2559,1081,1889,940,1655,5312,3826,7452,5686
5053,14787,3041,7237,1742,1822,1043,4333,1200,4038,1180,295,352,99,193,196,300,168,243,914,691,7550,1731,1362,856,4232,1186,3778,1109,454,465,313,390,141,239,922,594,1034,766
5055,35821,7220,17456,4099,4252,2345,10333,2884,9485,2778,848,962,561,804,287,512,669,731,2202,1535,18365,4155,3408,2053,10187,2833,9354,2717,833,921,531,719,302,549,1794,1213,2976,1849
5057,17114,4874,8044,2624,2427,1574,4389,1675,3953,1580,436,494,261,410,175,357,245,400,983,795,9070,3015,2124,1548,4451,1757,4069,1623,382,502,294,430,88,288,1149,949,1346,1027
5059,27911,6568,14436,3771,3884,2134,7992,2703,7141,2478,851,853,270,499,581,706,501,596,2059,1177,13475,3750,2445,1773,7682,2652,6968,2413,714,942,419,715,295,548,1464,1028,1884,1467
5061,10533,2436,4986,1480,1402,955,2780,973,2631,917,149,250,78,199,71,185,234,286,570,489,5547,1488,1386,874,2574,874,2388,844,186,259,142,237,44,159,758,584,829,562
5063,29956,7388,14576,4172,3966,2291,8227,2842,7684,2780,543,726,167,444,376,643,433,577,1950,1697,15380,4316,2979,2052,8022,2794,7335,2655,687,830,455,685,232,514,1948,1434,2431,1723
5065,11553,2607,6113,1510,1805,909,3076,900,2624,810,452,341,130,191,322,300,302,301,930,544,5440,1487,871,627,3064,912,2815,846,249,283,155,220,94,177,942,587,563,374
5067,14163,2935,6974,1837,2031,1050,3436,1232,2880,1052,556,473,182,283,374,397,319,366,1188,698,7189,1669,1958,910,2969,979,2191,802,778,485,375,373,403,326,1044,614,1218,714
5069,56688,15547,27803,9620,10992,6461,12501,5284,10235,4677,2266,2145,816,1380,1450,1658,844,1289,3466,2703,28885,8931,9272,5404,12091,5271,10506,4750,1585,1971,1023,1614,562,1204,3595,2746,3927,3113
5071,21087,4159,10317,2448,2969,1632,5613,1559,5144,1444,469,532,214,377,255,414,410,462,1325,890,10770,2536,2187,1355,5934,1714,5133,1488,801,772,437,558,364,502,1029,701,1620,906
5073,5719,1203,2757,719,788,412,1420,468,1321,446,99,111,47,88,52,105,163,181,386,288,2962,684,683,368,1446,471,1250,428,196,187,96,140,100,131,467,282,366,248
5075,13496,2668,6608,1595,1853,950,3639,1051,3445,1030,194,262,91,224,103,223,222,296,894,643,6888,1505,1243,717,3786,1083,3491,1038,295,333,209,304,86,224,791,475,1068,594
5077,7825,1783,4526,1166,1884,797,1774,673,1393,580,381,279,99,182,282,226,89,161,779,449,3299,954,1010,616,1484,580,1326,550,158,195,119,195,39,141,386,315,419,337
5079,11753,1939,7687,1428,3497,786,2672,840,1756,694,916,350,221,171,695,304,75,128,1443,422,4066,915,456,349,2667,763,2532,751,135,176,73,166,62,133,493,313,450,304
5081,10086,2419,4788,1457,1151,826,2735,994,2495,925,240,321,160,301,80,166,201,247,701,618,5298,1441,1053,731,2882,1011,2660,989,222,266,126,214,96,186,621,488,742,536
5083,17830,3642,8808,2168,2367,1378,4917,1352,4538,1244,379,466,206,343,173,332,275,330,1249,776,9022,2033,1546,940,5080,1427,4675,1313,405,490,290,411,115,248,1177,728,1219,829
5085,57089,9982,27701,5719,7340,3801,16546,3845,15592,3745,954,1137,563,904,391,744,733,932,3082,2120,29388,5912,5776,3019,16625,3954,15354,3685,1271,1404,687,1006,584,848,2774,1877,4213,2595
5087,13124,3019,6548,1721,1652,903,3835,1255,3620,1247,215,317,129,285,86,202,282,332,779,576,6576,1723,1243,803,3616,1202,3408,1181,208,293,51,160,157,288,838,653,879,687
5089,14006,3116,6762,1775,1493,906,3722,1201,3462,1123,260,339,103,233,157,264,384,353,1163,779,7244,1890,997,767,4116,1322,3623,1184,493,517,232,337,261,369,927,673,1204,816
5091,35052,9243,16927,5417,5809,3339,8236,3196,7375,2879,861,1087,535,891,326,690,551,798,2331,1890,18125,5350,4678,2824,8936,3423,7682,2994,1254,1348,904,1154,350,699,2069,1806,2442,1854
5093,32986,9220,15828,5666,5583,3655,7297,3208,6476,2928,821,1066,376,759,445,834,587,893,2361,1796,17158,5505,5407,3415,7517,3228,6449,2837,1068,1282,679,1027,389,805,1843,1577,2391,1936
5095,5810,1346,2692,764,858,515,1311,453,1221,442,90,148,50,120,40,124,164,152,359,274,3118,841,863,481,1288,448,1151,434,137,166,121,157,16,109,527,317,440,285
5097,7626,1544,3795,895,767,488,2312,625,2151,600,161,163,64,110,97,135,144,164,572,382,3831,884,546,382,2271,639,2145,616,126,165,101,153,25,89,521,357,493,319
5099,6776,1681,3340,1059,1043,656,1543,701,1327,617,216,222,31,103,185,207,218,262,536,405,3436,937,672,458,1683,695,1439,626,244,291,67,144,177,226,539,390,542,417
5101,6572,1568,3223,860,794,541,1672,521,1581,527,91,134,36,94,55,126,199,199,558,356,3349,1035,569,413,1691,589,1600,546,91,152,76,155,15,71,463,305,626,435
5103,19276,5915,9031,3487,3019,2040,4530,1967,3979,1762,551,744,363,637,188,421,429,611,1053,1068,10245,3531,2300,1677,4858,2233,3892,1803,966,1013,485,724,481,681,1529,1199,1558,1305
5105,8466,2020,4191,1116,958,526,2354,735,2258,716,96,143,35,117,61,123,139,203,740,495,4275,1110,804,536,2435,756,2347,748,88,139,67,124,21,118,466,381,570,386
5107,14607,4866,6612,2694,2398,1662,3228,1591,2740,1426,488,652,232,470,256,500,180,410,806,863,7995,3089,2684,1779,3314,1683,2695,1447,619,721,397,584,222,477,1141,1037,856,887
5109,8828,1723,4375,943,995,493,2803,714,2631,694,172,166,90,136,82,131,200,232,377,243,4453,1001,792,473,2548,646,2363,632,185,195,57,115,128,187,607,337,506,358
5111,19189,4246,9239,2535,2563,1480,5071,1601,4692,1532,379,485,195,381,184,387,281,385,1324,942,9950,2427,2058,1351,5062,1588,4670,1524,392,494,261,436,131,325,1188,790,1642,1080
5113,16331,3324,7925,2015,1874,1044,4508,1378,4261,1311,247,357,132,290,115,240,305,355,1238,878,8406,1794,1279,853,4924,1455,4440,1368,484,491,308,394,176,284,997,645,1206,763
5115,51465,10561,25019,6290,8447,3976,12746,3789,11749,3498,997,1264,623,980,374,699,670,937,3156,2497,26446,6280,7614,3744,12394,3681,11487,3423,907,1088,473,757,434,784,2588,1888,3850,2533
5117,6828,1330,3337,774,737,389,1965,578,1850,573,115,170,87,158,28,115,155,166,480,327,3491,774,564,374,2005,595,1915,584,90,146,40,136,50,122,520,322,402,287
5119,315989,80590,148575,48377,55344,33648,71502,26503,64317,23833,7185,9612,2787,5949,4398,7488,4004,6602,17725,15964,167414,48835,52854,31751,71636,26684,63236,23284,8400,10607,4586,7558,3814,7013,15968,13181,26956,18723
5121,14335,3458,7079,1968,1718,1064,4105,1372,3851,1349,254,285,130,241,124,243,318,387,938,728,7256,2020,1234,889,3960,1320,3583,1267,377,474,299,439,78,235,903,740,1159,805
5123,21011,5762,11538,3484,4637,2307,4759,2029,3563,1788,1196,703,382,476,814,578,227,401,1915,1316,9473,3250,3192,1987,3931,1895,3330,1633,601,745,356,541,245,519,1320,1022,1030,900
5125,96380,18977,46871,10903,12130,6836,27337,7151,25776,6783,1561,2068,691,1409,870,1492,1722,2044,5682,4096,49509,11458,10200,6379,26758,7049,24933,6665,1825,2223,846,1517,979,1565,4847,3282,7704,5128
5127,8209,1941,4148,1136,966,574,2458,798,2262,758,196,248,73,148,123,208,216,242,508,381,4061,1064,470,363,2509,801,2175,735,334,311,183,221,151,196,508,370,574,373
5129,6618,1818,3333,1042,535,411,2141,768,1985,726,156,203,55,141,101,177,130,184,527,405,3285,1017,476,399,1994,706,1882,689,112,169,48,135,64,153,368,296,447,357
5131,102041,25830,49438,15054,14949,8735,26621,9546,24069,8811,2552,3264,1305,2322,1247,2223,1651,2409,6217,5269,52603,15164,13228,8477,25939,9198,23325,8434,2614,3225,1428,2344,1186,2079,4919,4158,8517,6014
5133,12993,2821,6507,1639,1905,965,3590,1033,3368,997,222,281,129,212,93,185,283,303,729,536,6486,1583,1413,819,3552,1019,3260,966,292,304,117,173,175,243,742,489,779,579
5135,14211,3525,6953,2080,1595,1062,3775,1367,3338,1239,437,508,206,351,231,352,360,390,1223,855,7258,2086,1224,906,3749,1331,3313,1238,436,475,327,412,109,256,1117,768,1168,810
5137,10546,2799,5195,1592,1197,813,3102,1085,2860,974,242,360,175,311,67,170,232,299,664,542,5351,1624,603,550,2927,1012,2736,973,191,275,146,248,45,148,753,573,1068,824
5139,31474,9285,15095,5289,4701,3319,8042,3210,7519,3074,523,892,181,608,342,761,543,877,1809,1696,16379,5329,4112,2969,8008,3140,7229,2890,779,1108,508,889,271,691,1787,1564,2472,1952
5141,13973,2778,6847,1627,1474,862,4168,1123,3876,1085,292,370,107,237,185,276,286,325,919,620,7126,1592,1109,678,3958,1058,3689,1029,269,309,162,262,107,198,1007,620,1052,676
5143,184404,38138,91455,23787,35442,16899,45206,13605,42231,12831,2975,4025,973,2213,2002,3206,1983,2898,8824,6883,92949,22134,29643,14053,45632,13356,42352,12480,3280,4053,1327,2474,1953,3122,6865,5607,10809,7897
5145,63505,13937,30540,8311,8869,4850,17049,5297,15765,4897,1284,1673,782,1307,502,1021,778,1094,3844,3110,32965,8366,7891,4149,16817,5238,15390,4794,1427,1760,906,1325,521,965,3537,2503,4720,3237
5147,5328,1156,2467,638,554,360,1424,465,1289,445,135,157,87,134,48,110,190,177,299,207,2861,700,644,316,1435,472,1247,426,188,195,175,193,13,82,371,254,411,266
5149,17178,4018,8487,2277,2511,1359,4694,1506,4334,1451,360,442,198,353,162,294,329,381,953,798,8691,2369,1920,1294,4515,1418,4063,1320,452,511,249,359,203,342,1106,838,1150,856
6001,1367855,282646,666752,169124,261519,120601,348368,99770,313242,89780,35126,38168,8581,19005,26545,32696,12462,20729,44403,40454,701103,167072,241132,112196,341694,96758,304843,86964,36851,37957,12052,21158,24799,30752,49916,41561,68361,50534
6003,872,186,458,114,156,77,226,73,210,68,16,28,2,17,14,27,35,42,41,29,414,97,133,63,210,67,197,66,13,13,2,15,11,12,19,16,52,33
6005,33646,7012,18265,4322,5364,2314,9879,2972,8391,2681,1488,1001,487,636,1001,751,644,849,2378,1508,15381,3895,2923,1927,8711,2718,8095,2582,616,860,347,661,269,540,1507,1180,2240,1529
6007,188065,51619,92414,31099,38161,22309,41909,15699,38327,14596,3582,5105,1572,3593,2010,3859,2687,4145,9657,8585,95651,30041,30880,18998,41452,15592,37706,14461,3746,5079,2034,3797,1712,3601,9527,7763,13792,10183
6009,39203,9394,19513,5627,5958,3531,10131,3257,9177,2972,954,1165,283,586,671,976,716,912,2708,2033,19690,5490,4149,2854,10457,3468,9798,3248,659,981,320,686,339,749,2057,1712,3027,2140
6011,16590,3836,8516,2356,2914,1502,4825,1567,4304,1427,521,609,150,338,371,508,146,297,631,585,8074,2094,2196,1131,4460,1365,4041,1285,419,501,277,441,142,336,550,533,868,655
6013,927838,193276,449039,113367,156493,76329,249808,68440,228692,63118,21116,23942,6352,13092,14764,19700,9078,14070,33660,29879,478799,112428,140611,71786,246845,67008,222926,61476,23919,25083,9439,15285,14480,19189,35712,28139,55631,38244
6015,22514,4703,12096,2855,4858,1743,5352,1777,4378,1673,974,610,227,353,747,524,408,551,1478,999,10418,2783,2636,1569,4854,1777,4347,1648,507,605,252,411,255,438,1185,845,1743,1115
6017,157917,34218,78239,20567,23145,13126,45782,12826,42514,11984,3268,4085,1365,2695,1903,3192,2314,3235,6998,5827,79678,19312,18159,11239,45373,12639,42396,11953,2977,3824,1026,2297,1951,3146,6066,5193,10080,6994
6019,748422,173710,370496,104383,157007,74214,175816,58335,154120,52246,21696,22969,8081,13644,13615,17579,8000,12769,29673,26566,377926,99343,133833,66987,172906,56261,148608,50136,24298,24194,12064,16452,12234,16803,29658,24950,41529,30406
6021,21787,5391,10910,3175,3126,1664,6462,2226,5846,2112,616,772,160,367,456,647,173,339,1149,1015,10877,3047,2609,1562,6372,2211,5646,2040,726,826,388,603,338,507,787,672,1109,936
6023,114066,29643,56484,17887,24598,12848,23255,9103,21172,8552,2083,2803,844,1905,1239,2113,1627,2374,7004,5804,57582,17172,20004,11282,24179,9381,21346,8691,2833,3309,1389,2320,1444,2346,4806,4164,8593,6304
6025,137226,37133,70583,21053,30804,14198,32161,11299,25876,9867,6285,4757,1762,2537,4523,3808,2098,2829,5520,4870,66643,21145,24107,13119,29892,11192,23977,9196,5915,5350,2743,3300,3172,3717,6382,5309,6262,5411
6027,14941,2845,7512,1695,2575,1175,3876,1036,3458,987,418,395,145,268,273,302,257,259,804,529,7429,1718,1946,1021,3483,1036,3260,995,223,291,98,204,125,257,993,636,1007,648
6029,671039,160051,344888,95283,140731,65520,168021,54281,145874,48463,22147,20724,7569,11732,14578,15776,7576,11443,28560,23240,326151,87834,107991,56109,160468,51616,140066,46176,20402,20739,10068,13947,10334,14245,24280,20868,33412,26290
6031,115970,24601,65372,15336,27875,10746,30153,9116,24587,8132,5566,3566,1857,2034,3709,2761,1382,1772,5962,3960,50598,13209,16292,8321,25843,8009,22358,7258,3485,3299,1473,2104,2012,2424,3432,2980,5031,4039
6033,53118,13945,26297,7961,8326,4550,12846,5124,11297,4736,1549,1905,559,1038,990,1508,1483,1797,3642,2839,26821,8180,6503,4089,12418,4892,10862,4466,1556,1903,685,1148,871,1364,3283,2739,4617,3087
6035,26991,4301,18284,2763,8880,1722,7158,1894,4915,1635,2243,694,441,420,1802,613,363,485,1883,990,8707,2220,1528,1002,5224,1637,4856,1560,368,509,163,381,205,417,888,731,1067,843
6037,8246401,1816473,4029943,1083547,1809550,775388,1866922,605192,1624712,539862,242210,242663,73402,131984,168808,199185,80917,131840,272554,247860,4216458,1060437,1627478,711188,1859232,590993,1585522,525278,273710,253728,114262,158182,159448,190798,325188,262968,404560,299742
6039,119454,29684,56778,17209,20485,11014,30350,9915,27393,9089,2957,3075,1065,1720,1892,2497,1446,2068,4497,3726,62676,16648,19689,9865,31430,10181,27573,9126,3857,3559,1854,2438,2003,2387,5079,4101,6478,4886
6041,216975,42429,105270,26395,31541,16731,60590,17242,56162,16251,4428,5283,1275,3161,3153,4402,2470,4132,10669,8745,111705,24741,29263,15423,57129,15815,53159,15056,3970,5159,1494,3353,2476,4075,8773,7230,16540,10505
6043,15041,3557,7659,2175,2068,1169,4290,1493,3817,1334,473,513,74,254,399,477,287,402,1014,785,7382,2030,1527,1060,4092,1371,3725,1265,367,459,176,353,191,306,820,681,943,789
6045,71624,19064,35320,11239,12553,7113,17206,6884,15373,6387,1833,2332,584,1362,1249,1944,979,1623,4582,3973,36304,10960,9191,5841,17182,6816,15337,6351,1845,2337,858,1608,987,1783,3607,3150,6324,4665
6047,204409,49570,102650,29456,43050,20864,49988,16406,44979,15163,5009,5432,1794,3188,3215,4337,1988,3145,7624,6913,101759,27429,35450,17702,49050,15950,42426,14186,6624,6382,3360,4357,3264,4340,7665,6599,9594,7391
6049,7466,2047,3877,1350,1063,756,1980,797,1777,764,203,237,51,173,152,201,178,308,656,482,3589,1199,776,615,1850,838,1622,770,228,341,54,177,174,285,418,379,545,397
6051,12257,5596,6453,3701,3196,2801,2236,1467,1918,1315,318,521,152,371,166,352,225,433,796,1015,5804,3095,2100,2000,2634,1674,2166,1432,468,705,286,495,182,416,440,636,630,808
6053,337504,74399,171910,44795,73154,31568,83110,24927,72305,22227,10805,9768,2730,4528,8075,8295,4167,5573,11479,9239,165594,41112,58259,27443,80115,24038,71098,21860,9017,9059,3540,5496,5477,7098,12113,9844,15107,11034
6055,115870,24465,57301,14974,19751,9811,30939,9000,28182,8123,2757,3234,707,1746,2050,2794,1456,1953,5155,3969,58569,13684,16594,8240,28763,8310,26123,7559,2640,2949,903,1831,1737,2403,5389,3692,7823,4919
6057,85291,21001,41737,12202,11979,7597,23211,7676,21475,7231,1736,2296,702,1544,1034,1702,1226,1750,5321,4350,43554,12173,9604,6838,22927,7496,21361,7084,1566,2150,513,1320,1053,1763,4864,3804,6159,4505
6059,2588447,544545,1267287,324336,476494,220951,674446,191200,605873,173121,68573,70632,16747,35473,51826,60298,25661,39981,90686,80257,1321160,314375,408007,197244,670295,187571,596057,169591,74238,73057,24807,41289,49431,58351,99004,78444,143854,101532
6061,315056,54246,152253,32714,44255,21712,90356,20595,85307,19667,5049,6066,1968,4095,3081,4735,4201,5204,13441,10255,162803,31685,36101,18718,91343,20551,84952,19553,6391,6776,2751,4507,3640,5212,14521,9608,20838,12604
6063,16071,4516,8021,2624,2325,1539,4275,1800,3967,1737,308,500,106,349,202,403,430,568,991,854,8050,2600,1535,1226,4343,1776,3914,1664,429,550,225,431,204,395,831,782,1341,1095
6065,1905623,377455,942570,222292,361039,152024,483779,127131,427060,114256,56719,51083,17116,26395,39603,41133,20778,26467,76974,57473,963053,217454,303041,136786,473972,123511,409347,108984,64625,54964,25618,32076,39007,41202,79221,55239,106819,66749
6067,1221525,251554,590483,151225,228470,105874,294528,88681,262754,81095,31774,32899,11842,20213,19932,25326,12880,19542,54605,44031,631042,150271,201648,96853,293184,87935,258832,79862,34352,35242,16383,23585,17969,24378,51491,40414,84719,54674
6069,47563,11620,23779,6625,8960,4392,12454,3770,11458,3493,996,1123,245,575,751,1042,502,747,1863,1660,23784,6448,7247,3767,12453,3717,11176,3411,1277,1332,481,793,796,1068,1674,1487,2410,1855
6071,1675035,388457,827575,223402,338767,153132,403979,125889,357094,114791,46885,45420,15130,25400,31755,35979,17805,26006,67024,53891,847460,221370,284882,138976,404666,125569,351414,112454,53252,50887,25242,33817,28010,34810,63542,52405,94370,66647
6073,2710720,565520,1359964,347080,546603,246144,674846,196775,602968,176856,71878,74100,19695,38538,52183,61146,27853,41841,110662,93614,1350756,327116,425251,211509,661828,188053,587036,171022,74792,73765,27585,43228,47207,57548,99471,79405,164206,109797
6075,774244,167795,394867,107468,196566,83581,165182,59367,143638,53467,21544,22769,4837,11017,16707,19708,6863,12166,26256,24966,379377,100576,158330,71693,157427,56758,137017,51243,20410,21377,5565,11343,14845,17834,28549,24351,35071,28796
6077,574484,120718,284010,71686,109880,48180,144170,41649,127898,37842,16272,15433,5165,8885,11107,12180,7060,9408,22900,18150,290474,68280,92303,43251,143596,40725,125416,36748,18180,16626,7609,10192,10571,12243,25105,18264,29470,20117
6079,240564,50530,121736,32392,47751,23216,60664,17971,55559,16609,5105,5749,1863,3600,3242,4359,2963,3949,10358,8297,118828,28822,36241,18771,58560,16948,54028,15926,4532,5352,2257,3857,2275,3754,9361,7344,14666,9911
6081,634228,130983,311197,78528,112235,53545,172261,47969,155127,42811,17134,18305,3132,7802,14002,16617,6448,9803,20253,18634,323031,75252,94921,46609,170896,46027,152627,41624,18269,18297,6037,10241,12232,14628,24911,19395,32303,23304
6083,361625,91732,180353,55240,77835,38275,85359,30002,75987,27179,9372,10223,2574,5610,6798,8646,3847,6375,13312,12333,181272,51615,66644,33551,82713,28655,73350,26003,9363,10365,3685,6656,5678,7978,12783,11438,19132,14811
6085,1569382,302592,790818,184021,296044,131655,435071,110561,389560,100368,45511,43085,9022,19624,36489,38073,13079,21469,46624,42420,778564,172416,231533,109954,424056,106912,380993,97773,43063,41325,13357,22834,29706,33415,52796,42555,70179,51388
6087,230034,60088,113257,35503,47932,25274,53287,19286,48735,17951,4552,6195,1250,3467,3302,5309,1971,3801,10067,9082,116777,34056,42784,23049,52208,18717,47198,17211,5010,6268,1831,3968,3179,4895,7800,7282,13985,10118
6089,147221,31172,71729,18370,22122,12136,38010,11488,34962,10801,3048,3637,1258,2418,1790,2826,2586,3107,9011,6524,75492,18577,17937,10675,38987,11712,35857,11009,3130,3815,1433,2627,1697,2815,7246,5459,11322,7335
6091,2612,679,1388,441,514,290,700,330,639,302,61,103,36,92,25,71,3,44,171,152,1224,386,237,174,644,294,559,272,85,125,6,47,79,122,153,135,190,179
6093,36118,6293,17903,3822,5126,2375,9279,2493,8575,2387,704,822,188,464,516,737,772,788,2726,1582,18215,3761,3735,1967,9452,2515,8905,2407,547,684,262,505,285,552,2092,1331,2936,1676
6095,359655,79119,177585,45784,66313,31047,91341,27678,81182,25388,10159,9870,3389,6206,6770,7568,4336,6090,15595,12631,182070,46003,52592,27691,90959,27728,80787,25246,10172,10633,4475,6993,5697,7697,14542,11868,23977,15943
6097,418178,101374,202427,60829,72046,39469,103304,35591,93798,32461,9506,12558,3326,7474,6180,10098,4670,7848,22407,19194,215751,58337,62020,36117,103777,34908,93749,32259,10028,12547,3985,7855,6043,9633,17441,15098,32513,22241
6099,420302,95453,206382,56111,78126,38222,105934,32565,96402,30034,9532,10849,3554,6443,5978,8495,4947,7163,17375,14892,213920,54459,66149,34700,105088,31767,93576,28869,11512,11985,5318,7890,6194,8452,16836,13739,25847,18150
6101,75247,15306,37101,8931,11459,5521,20979,6191,18656,5690,2323,2164,657,1223,1666,1803,903,1200,3760,2862,38146,8859,9136,4787,20641,6083,18438,5633,2203,2123,903,1394,1300,1528,3347,2346,5022,3364
6103,51256,12994,25275,7711,8100,4820,12977,4731,11423,4312,1554,1866,566,1019,988,1374,1093,1319,3105,2631,25981,7431,5880,4149,14015,4961,12304,4550,1711,1867,690,1054,1021,1416,2510,2136,3576,2714
6105,10946,2736,5618,1698,1552,953,2699,1070,2415,1008,284,346,79,187,205,304,313,377,1054,742,5328,1544,968,746,2791,1090,2537,1016,254,360,69,201,185,312,735,546,834,590
6107,342228,89513,169725,51163,68095,33833,85340,29651,77230,27645,8110,9378,3366,5853,4744,7207,4027,6107,12263,11194,172503,49919,57114,31122,85212,29351,74927,26808,10285,10971,5185,7405,5100,7268,13068,11228,17109,13318
6109,46588,12173,24296,7073,7414,4121,12490,4667,10949,4271,1541,1396,674,1064,867,950,853,1224,3539,2803,22292,6861,4487,3507,12149,4668,11252,4434,897,1227,402,857,495,951,2396,2108,3260,2746
6111,685317,131522,336962,79321,127461,55550,175970,45749,159809,41609,16161,17188,4432,8921,11729,14064,8089,10627,25442,20331,348355,75360,106264,47751,174639,44999,157372,40926,17267,17054,6371,10037,10896,13116,26803,19288,40649,25167
6113,179216,36609,86194,23114,38440,17689,40963,12148,37374,11354,3589,4311,1242,2488,2347,3437,1629,2735,5162,4725,93022,22988,37554,16434,41149,12171,36512,11113,4637,4903,2084,3130,2553,3502,5249,4498,9070,6426
6115,58443,14054,29591,8453,10655,5661,15191,5252,14041,4992,1150,1432,495,1036,655,1070,887,1186,2858,2307,28852,7702,7339,4250,15667,5351,14203,5022,1464,1643,879,1287,585,1001,2356,2011,3490,2520
8001,390359,80776,196365,49425,72326,34396,98765,28335,89165,25387,9600,10723,2766,5496,6834,8892,4420,6428,20854,15272,193994,45966,57447,29219,98868,27887,88492,25107,10376,11000,4469,6849,5907,8083,12217,10844,25462,16387
8003,12752,3166,6327,1892,2698,1364,2975,1111,2731,1062,244,337,111,271,133,244,95,234,559,494,6425,1930,2029,1156,3123,1167,2960,1169,163,235,66,167,97,238,538,466,735,583
8005,517041,100520,253737,61328,90259,43050,133490,36738,123028,33603,10462,13005,3200,7530,7262,10614,4609,7682,25379,19583,263304,59801,75693,38321,133303,36279,122301,33283,11002,13085,4580,8615,6422,10000,16706,14150,37602,23182
8007,11261,2133,5622,1320,1168,672,3713,976,3547,949,166,206,92,187,74,139,95,162,646,432,5639,1125,916,509,3456,865,3242,864,214,230,75,151,139,189,445,305,822,542
8009,2932,390,1414,217,293,126,902,165,826,162,76,57,32,34,44,51,47,48,172,101,1518,256,225,115,925,193,875,191,50,79,16,46,34,74,240,105,128,73
8011,5064,795,3416,608,1453,419,1396,397,794,311,602,201,140,113,462,154,96,91,471,218,1648,356,256,136,916,267,877,260,39,64,24,58,15,66,245,149,231,147
8013,271539,47973,136161,31042,57096,24456,64124,16629,60143,15779,3981,5389,1321,3473,2660,4350,2299,3919,12642,9206,135378,29735,46332,21259,64283,16535,60249,15752,4034,5434,1524,3623,2510,4275,7660,6551,17103,10677
8014,55019,9242,27300,5528,8540,3755,15919,3775,15403,3701,516,921,241,702,275,759,446,778,2395,1780,27719,5547,6953,3317,15727,3876,15034,3762,693,1078,370,850,323,791,1745,1391,3294,2031
8015,17087,3920,9146,2406,2524,1361,5351,1799,4634,1653,717,504,138,241,579,498,390,439,881,762,7941,2183,1224,968,4689,1573,4513,1558,176,307,65,217,111,261,863,689,1165,925
8017,1515,310,768,176,226,111,455,121,427,118,28,39,5,19,23,38,22,24,65,47,747,190,117,86,414,111,401,110,13,28,4,29,9,26,123,66,93,65
8019,8351,1483,4187,851,1212,528,2098,622,1879,590,219,287,26,75,193,273,137,170,740,401,4164,861,1016,511,2202,627,2080,612,122,160,3,64,119,159,306,278,640,395
8021,6379,920,3224,538,936,355,1715,357,1556,352,159,118,84,100,75,81,163,117,410,193,3155,527,815,300,1635,362,1503,350,132,117,44,75,88,100,371,179,334,160
8023,3225,548,1705,322,449,202,819,236,728,230,91,90,30,55,61,73,135,101,302,158,1520,312,282,156,731,226,717,226,14,32,14,32,0,48,217,124,290,162
8025,5169,1016,3347,758,1536,544,1336,384,800,246,536,264,154,144,382,187,21,39,454,282,1822,482,628,385,709,236,582,195,127,145,29,41,98,143,186,104,299,154
8027,4236,1002,2176,577,279,226,1492,471,1477,468,15,50,12,47,3,42,104,148,301,216,2060,525,256,192,1473,443,1448,444,25,59,3,41,22,58,102,95,229,156
8029,25609,6045,12931,3439,3040,1672,7135,2351,6315,2158,820,771,172,375,648,687,759,684,1997,1540,12678,3487,2058,1482,7313,2431,6705,2254,608,810,153,403,455,736,1300,1006,2007,1437
8031,585637,126343,292479,81022,134974,61496,120573,44503,107597,40130,12976,16632,4133,9606,8843,13615,5960,10424,30972,25073,293158,75971,114092,52802,120832,43598,106525,39278,14307,17223,6190,11241,8117,12708,17570,17203,40664,28018
8033,1473,314,762,188,180,93,450,147,390,127,60,65,21,42,39,53,44,46,88,76,711,169,112,76,445,130,409,127,36,37,27,35,9,13,48,43,106,71
8035,263779,38902,130526,23590,33544,16141,85970,15761,83096,15298,2874,4044,800,2531,2074,3506,1653,2869,9359,7148,133253,22198,28794,14297,84487,15356,81495,14865,2992,3997,927,2453,2065,3427,6101,5259,13871,8260
8037,44727,11549,23894,7965,9412,5677,11178,3999,10328,3727,850,1318,178,635,672,1032,97,436,3207,2840,20833,6145,6383,3950,11691,4039,10573,3741,1118,1298,334,652,784,1059,503,837,2256,2137
8039,21351,3404,10746,1955,2624,1255,7036,1332,6753,1296,283,357,57,204,226,317,163,250,923,648,10605,1979,2063,1059,6651,1381,6361,1279,290,372,153,303,137,238,602,527,1289,725
8041,557283,98096,280584,61527,96017,43920,151314,36952,142020,34874,9294,11535,3308,7178,5986,9258,5853,8307,27400,19852,276699,57043,69878,35470,151817,36115,139176,33918,12641,13113,5138,8442,7503,9764,17265,14548,37739,23011
8043,41275,8141,24520,5601,7608,3489,12507,3504,8584,2666,3923,1488,731,816,3192,1299,712,877,3693,1938,16755,3966,2632,1985,9777,2891,9222,2751,555,792,151,503,404,703,1696,1295,2650,1682
8045,46474,10600,23663,6311,6841,3851,13936,4254,13021,4077,915,1166,142,537,773,1044,486,819,2400,1852,22811,5888,5355,3342,13359,4080,12653,3859,706,978,280,665,426,758,1391,1307,2706,1930
8047,5345,1071,2692,629,670,359,1540,498,1434,484,106,126,21,58,85,111,72,134,410,291,2653,644,433,312,1563,519,1407,462,156,197,59,99,97,152,209,206,448,291
8049,13174,3454,6986,2072,2178,1057,3524,1357,3213,1266,311,381,58,185,253,304,261,373,1023,879,6188,1897,1492,899,3373,1301,3041,1215,332,373,141,193,191,279,653,553,670,542
8051,14440,4182,7847,2731,3981,2063,2926,1245,2759,1209,167,333,59,278,108,288,234,395,706,686,6593,2343,2558,1658,3056,1327,2867,1259,189,400,86,316,103,308,263,418,716,712
8053,758,94,352,49,58,28,239,40,235,39,4,6,0,12,4,6,24,15,31,18,406,60,33,16,289,41,240,39,49,24,0,12,49,24,27,14,57,29
8055,5749,1299,2806,805,685,483,1519,508,1414,494,105,142,0,84,105,142,149,189,453,358,2943,794,521,388,1673,537,1501,511,172,199,19,93,153,194,427,285,322,267
8057,1126,218,571,125,111,66,385,114,352,108,33,32,10,26,23,24,16,25,59,46,555,121,116,88,341,91,324,90,17,20,0,24,17,20,65,47,33,33
8059,480257,88250,237982,55017,78012,39251,127784,33686,119881,31728,7903,10634,2282,6725,5621,9182,5616,8343,26570,19226,242275,51782,62612,32707,128756,33561,121251,32078,7505,10203,3375,7395,4130,7907,17302,14362,33605,20889
8061,1133,165,513,99,138,68,319,68,309,65,10,23,0,24,10,23,27,26,29,29,620,107,96,52,316,73,307,70,9,16,2,16,7,14,125,67,83,45
8063,5925,1488,3166,1061,704,400,2040,789,1582,507,458,432,117,174,341,351,116,129,306,235,2759,640,429,270,1779,519,1716,502,63,115,41,123,22,83,321,201,230,185
8065,6670,1977,3667,1251,1305,835,1595,771,1438,751,157,218,23,88,134,207,3,93,764,801,3003,1269,900,772,1613,855,1504,832,109,187,29,116,80,167,160,218,330,375
8067,46723,8933,23406,5760,7981,3909,12177,3247,11270,3025,907,1048,256,539,651,880,505,745,2743,1845,23317,4936,6518,3197,12454,3260,11693,3127,761,836,103,422,658,795,1546,1246,2799,1695
8069,288130,50304,143153,31916,54740,24733,73108,17503,69960,16912,3148,4567,1149,3148,1999,3780,2748,4206,12557,9419,144977,30507,45603,21751,73679,17844,70192,17075,3487,4849,1403,3338,2084,3919,8789,7201,16906,10519
8071,12193,2582,6416,1757,1930,1069,3417,1128,3019,1044,398,358,73,206,325,310,171,237,898,675,5777,1321,1216,794,3183,951,2909,930,274,275,162,278,112,214,711,521,667,485
8073,4650,1626,3070,1430,1401,502,1300,842,579,461,721,511,80,80,641,475,72,65,297,233,1580,370,175,129,932,295,871,269,61,85,25,56,36,66,236,154,237,140
8075,18604,4186,10222,2729,3639,2008,5115,1709,4417,1433,698,762,221,415,477,609,160,256,1308,959,8382,2457,2089,1451,4083,1222,3787,1139,296,410,87,248,209,346,1080,784,1130,828
8077,123706,25481,60533,15541,18569,10078,32601,9987,30419,9433,2182,2959,801,1842,1381,2363,1853,2461,7510,5579,63173,14496,14748,8322,32241,9629,30055,9219,2186,2622,995,1792,1191,2025,6195,4472,9989,6230
8079,741,99,373,53,80,39,259,44,245,40,14,13,13,13,1,2,10,11,24,16,368,55,57,44,238,38,236,37,2,3,0,12,2,3,31,18,42,23
8081,10331,2743,5255,1648,1564,1102,2949,1075,2668,1033,281,348,53,208,228,313,155,292,587,570,5076,1597,943,680,2967,1105,2707,1034,260,361,157,313,103,229,470,444,696,596
8083,21364,4773,10423,2767,2864,1755,5742,1764,5569,1742,173,357,69,306,104,303,352,481,1465,1122,10941,2756,2386,1406,6127,1891,5650,1775,477,661,235,448,242,468,879,722,1549,1112
8085,34205,7042,16711,4148,3741,2362,10391,2992,9692,2789,699,874,97,464,602,795,687,921,1892,1507,17494,4020,3276,2255,10424,2866,9457,2762,967,1032,257,581,710,904,1685,1195,2109,1482
8087,22309,5101,11214,3101,2932,1629,6860,2439,6028,2059,832,1018,297,573,535,794,241,346,1181,970,11095,2765,2147,1489,6281,2121,5775,1975,506,612,220,435,286,465,1101,819,1566,1060
8089,14659,3403,7110,2005,2080,1237,3755,1360,3457,1274,298,476,214,384,84,288,358,439,917,740,7549,1982,1946,1083,3720,1349,3524,1314,196,365,133,329,63,248,881,677,1002,767
8091,4167,658,2068,391,445,235,1327,273,1217,255,110,84,41,66,69,64,66,71,230,146,2099,377,347,193,1329,269,1217,248,112,106,29,67,83,92,134,103,289,141
8093,15587,3974,8332,2287,2186,1175,4734,1449,4466,1397,268,361,122,283,146,263,309,465,1103,966,7255,2152,1279,916,4586,1441,4478,1402,108,231,0,144,108,231,339,483,1051,842
8095,3302,761,1820,510,598,341,1010,329,974,324,36,70,10,67,26,58,43,68,169,122,1482,375,204,159,952,290,857,263,95,120,37,91,58,91,160,129,166,142
8097,15549,4442,7949,2942,3141,2018,3108,1453,2842,1338,266,403,0,156,266,403,89,243,1611,1330,7600,2669,2758,1878,3112,1411,2947,1387,165,251,16,171,149,236,293,446,1437,1175
8099,9469,2332,4791,1469,1494,885,2535,875,2393,842,142,268,65,219,77,217,186,259,576,539,4678,1276,1022,677,2479,842,2304,799,175,278,35,185,140,240,556,452,621,510
8101,135036,27524,65858,17039,23944,12471,30978,9434,28261,8726,2717,3226,1035,2256,1682,2612,2234,2938,8702,6178,69178,16706,19654,10844,32604,9741,29678,9042,2926,3613,1177,2433,1749,2774,6037,4701,10883,6938
8103,5041,1126,2540,659,669,403,1366,441,1216,400,150,156,33,99,117,137,125,153,380,263,2501,725,631,440,1304,417,1241,403,63,113,33,103,30,91,214,220,352,279
8105,9228,2253,4626,1331,1230,695,2634,901,2396,827,238,317,141,244,97,177,210,258,552,496,4602,1277,926,690,2486,852,2310,799,176,273,70,167,106,218,481,377,709,474
8107,21443,5019,11251,3210,4292,2369,5302,1582,5076,1559,226,376,52,253,174,337,375,513,1282,1085,10192,2816,2633,1674,5787,1766,5325,1642,462,624,147,359,315,480,384,445,1388,1036
8109,5402,970,2770,591,787,334,1513,464,1391,440,122,155,38,79,84,141,77,105,393,254,2632,546,378,233,1602,464,1434,450,168,168,78,113,90,128,169,147,483,252
8111,522,87,274,55,86,33,129,33,120,33,9,6,3,4,6,6,12,14,47,26,248,45,32,20,138,34,129,34,9,11,0,12,9,11,29,21,49,21
8113,6814,1010,3578,640,1362,481,1686,410,1550,378,136,147,23,77,113,130,48,86,482,265,3236,648,956,426,1720,441,1612,422,108,130,19,65,89,129,95,109,465,256
8115,1828,250,889,143,235,87,500,106,470,102,30,31,8,13,22,28,35,23,119,61,939,166,195,82,487,96,441,88,46,39,22,20,24,32,141,74,116,53
8117,26493,8603,14575,5606,6521,3978,6108,2755,5013,2319,1095,1271,149,422,946,1210,255,456,1691,1848,11918,4738,4356,3088,5732,2621,5518,2454,214,562,61,331,153,495,271,515,1559,1648
8119,21027,3984,10747,2498,2777,1525,6016,1592,5764,1571,252,329,84,226,168,295,334,460,1620,1123,10280,2236,1870,1188,6373,1695,6237,1665,136,260,77,237,59,197,720,723,1317,979
8121,3964,477,2044,332,558,210,1260,249,1133,229,127,107,55,73,72,83,50,52,176,96,1920,254,376,142,1204,219,1122,222,82,75,37,62,45,55,180,93,160,99
8123,237777,42625,119665,25818,36942,17831,68690,16057,64056,15169,4634,5306,1199,2953,3435,4511,2487,3653,11546,8406,118112,24805,30018,14743,65830,15494,61118,14525,4712,5376,2088,3627,2624,4047,8212,6523,14052,9279
8125,7733,1801,3851,1162,921,648,2527,814,2322,778,205,262,30,112,175,244,109,178,294,257,3882,924,735,443,2233,733,2109,701,124,201,18,112,106,189,547,380,367,292
9001,769609,170627,370754,101261,131493,68054,203882,59887,188432,55013,15450,19725,4595,11747,10855,16395,8347,13412,27032,25413,398855,99585,121712,63988,200610,57840,184807,53561,15803,19839,6407,13163,9396,15330,33804,26992,42729,31698
9003,739475,160437,355624,97090,138087,69077,175864,55400,163669,52054,12195,17092,3410,10688,8785,14603,9437,14215,32236,28444,383851,94528,126593,63799,173998,53907,160956,50593,13042,17708,5550,12419,7492,13659,33376,25871,49884,35156
9005,155356,31176,76262,18824,24504,12718,41386,11642,39136,11181,2250,3276,681,2212,1569,2753,2408,3103,7964,6212,79094,18045,19266,11017,41859,11741,39778,11322,2081,3138,648,2095,1433,2805,7451,5566,10518,7061
9007,139843,28197,67641,16909,23047,11510,36586,10967,34709,10464,1877,2869,642,1905,1235,2380,1578,2421,6430,5365,72202,16596,19628,10211,35975,10454,34387,10226,1588,2596,555,1819,1033,2203,6337,5049,10262,6769
9009,715373,170501,340728,101697,139591,72179,160500,55591,148334,52196,12166,17065,3600,10729,8566,14167,9913,14728,30724,28496,374645,101408,131842,68228,161119,55606,147761,51684,13358,18080,5917,12377,7441,13715,34482,27496,47202,34657
9011,224773,44122,112188,27303,41670,19196,55400,16501,51799,15564,3601,4822,1173,3268,2428,3914,2866,4053,12252,9228,112585,25896,31690,15916,55194,16260,51653,15500,3541,4650,1319,3203,2222,3768,9663,7649,16038,10285
9013,129880,24691,64660,15327,26692,11442,30972,8519,29609,8181,1363,2071,456,1550,907,1719,1471,2138,5525,4570,65220,14627,23284,10179,30498,8282,29279,8025,1219,2114,445,1569,774,1732,4540,3872,6898,4947
9015,97632,22301,47958,13509,17422,8906,23982,8045,22203,7582,1779,2396,752,1704,1027,1812,1337,1938,5217,4575,49674,12739,15456,7969,23430,7674,21993,7331,1437,2163,713,1683,724,1524,4225,3489,6563,4845
10001,142783,24024,67974,14531,23985,10363,35036,8579,32654,8128,2382,2595,1085,1708,1297,1865,1730,2038,7223,4845,74809,14190,22548,9080,34456,8218,31446,7750,3010,3038,1624,2086,1386,1962,7376,4343,10429,5495
10003,456639,96848,218907,57488,87026,41611,106652,32068,98585,29997,8067,10244,2703,6314,5364,8531,5818,8309,19411,16159,237732,58681,82788,39814,105754,31703,96469,29139,9285,11491,4019,7596,5266,8679,19663,15570,29527,20405
10005,189016,33321,90718,19264,24735,12072,54399,12866,50709,12212,3690,3899,1223,2250,2467,3337,3104,3409,8480,6123,98298,19606,21566,11375,54195,12715,50355,11965,3840,4335,1715,3050,2125,2994,10376,6238,12161,7134
11001,584437,125830,273927,80244,157830,66636,92123,37720,77693,32722,14430,16623,5535,10098,8895,12626,4625,8633,19349,18174,310510,81207,171596,65214,89051,36626,72799,30869,16252,17652,6547,10686,9705,13583,19319,17358,30544,23679
12001,225192,52998,107765,32330,53369,25630,42912,14909,38402,13322,4510,5669,1318,3274,3192,4770,2095,3623,9389,8260,117427,34177,53587,25444,42191,14941,37181,12994,5010,6264,1591,3409,3419,5162,8129,6715,13520,9721
12003,22696,5751,11846,3321,4690,2202,5577,1896,5003,1857,574,483,144,235,430,441,343,357,1236,911,10850,3307,2961,2052,5332,1901,4883,1840,449,497,174,317,275,396,1216,935,1341,1062
12005,149476,32735,74012,19669,24426,13058,38311,11767,34260,10650,4051,4696,1632,2891,2419,3391,2388,3003,8887,6518,75464,19033,17749,10569,37950,11508,33605,10277,4345,4710,2484,3576,1861,2798,8088,5912,11677,7653
12007,22704,5904,12551,3874,5338,2457,5060,2011,4096,1676,964,875,333,483,631,727,407,518,1746,1228,10153,3063,2323,1659,5033,1892,4462,1808,571,629,296,451,275,401,1213,998,1584,1187
12009,497541,105650,241177,61850,75668,41499,125563,36937,115960,34292,9603,12213,4079,8022,5524,9111,9594,11307,30352,22049,256364,64512,59755,36466,125469,36830,114193,33782,11276,13325,4535,8265,6741,10140,30424,21073,40716,26687
12011,1586917,357588,765666,213996,294653,145394,365556,120492,318850,106723,46706,49914,16210,27697,30496,38712,19779,27751,85678,66679,821251,214604,261949,134070,358827,116613,306054,101765,52773,52073,24738,33405,28035,36786,74544,56828,125931,78148
12013,12010,2660,6647,1647,2580,959,2546,1013,2177,926,369,310,171,254,198,203,260,296,1261,745,5363,1543,1215,865,2537,929,2280,895,257,285,177,263,80,204,788,528,823,561
12015,163204,33960,79007,19747,18700,11619,46026,12702,42705,11845,3321,3945,1179,2481,2142,3138,4059,4195,10222,7576,84197,20542,12824,9000,46091,12782,42756,12026,3335,4093,1363,2688,1972,3155,13092,8551,12190,8480
12017,127560,27402,61310,16444,15668,10261,34523,10401,32070,9842,2453,3195,882,1984,1571,2523,3371,3689,7748,5763,66250,16124,11701,8195,34020,10249,31117,9640,2903,3582,1169,2279,1734,2777,10939,6712,9590,6513
12019,171306,32707,83643,19284,24028,12189,48578,12289,45233,11446,3345,4025,1247,2338,2098,3028,2161,2660,8876,6552,87663,19026,19930,10373,49305,12375,43923,11058,5382,5335,2159,3055,3223,3890,7191,5316,11237,7099
12021,318351,69645,155803,40810,39876,22814,93985,26732,83807,23140,10178,11107,2149,4679,8029,9637,5317,6395,16625,13376,162548,40208,33243,20097,89344,24570,80471,22057,8873,9623,2975,5102,5898,7789,18674,13237,21287,15173
12023,57326,12278,29838,7278,10904,4861,13436,4352,11463,3922,1973,1873,630,1033,1343,1479,1095,1286,4403,2763,27488,7203,6411,4037,13709,4497,11800,4043,1909,1984,1002,1398,907,1306,3106,2136,4262,2709
12027,31021,8082,17876,5631,7546,4004,7930,2898,6839,2595,1091,1168,411,731,680,858,504,725,1896,1350,13145,3818,3106,1861,6255,2215,5699,1997,556,807,277,592,279,571,1809,1286,1975,1552
12029,14090,3575,7924,2167,2580,1204,3885,1474,3420,1397,465,404,184,322,281,269,281,348,1178,842,6166,1820,974,772,3547,1357,3179,1277,368,456,180,319,188,316,707,565,938,715
12031,756847,160953,362625,96756,140326,69976,170047,53922,152981,49493,17066,18910,6646,12104,10420,14518,8877,13056,43375,32374,394222,97228,126403,63445,171423,54136,150852,48797,20571,21788,9962,14619,10609,15413,33997,26138,62399,38008
12033,258336,55746,127023,34693,50073,24739,56935,19452,50865,17862,6070,6629,2426,4574,3644,4895,4735,5694,15280,11415,131313,33604,41005,21427,55545,18751,49258,17013,6287,7216,3427,5291,2860,4752,13768,9750,20995,13723
12035,94577,18043,44994,10236,11723,6198,26018,6720,23756,6180,2262,2491,774,1421,1488,1972,2147,2179,5106,3591,49583,11120,11349,6467,25768,6555,23692,6149,2076,2257,835,1406,1241,1744,6268,3994,6198,3996
12037,10200,2095,5901,1427,2150,878,2533,874,2124,805,409,302,85,212,324,275,246,282,972,545,4299,1050,749,510,2256,801,2095,755,161,255,51,199,110,224,554,411,740,521
12039,37554,9105,17619,5645,7036,3723,8161,3263,7319,3023,842,1031,299,664,543,840,792,1002,1630,1490,19935,5214,7619,3689,7462,2863,6380,2637,1082,1050,651,881,431,630,1822,1436,3032,1934
12041,15170,3291,7979,2082,3093,1484,3475,1023,3237,1006,238,274,113,208,125,228,191,245,1220,799,7191,1834,1453,873,3621,1100,3327,1042,294,356,214,327,80,180,857,608,1260,838
12043,11722,3041,6661,1810,2452,1112,2803,1157,2080,924,723,643,311,368,412,457,380,339,1026,640,5061,1794,850,765,2831,1138,2465,1026,366,426,236,363,130,253,569,541,811,680
12045,13463,3090,7992,1980,2798,1195,3609,1342,3038,1234,571,494,189,339,382,399,306,401,1279,752,5471,1707,821,658,3012,1176,2761,1102,251,402,128,318,123,279,699,540,939,818
12047,12084,2328,7124,1539,3467,1106,2521,828,1961,772,560,243,146,168,414,205,182,192,954,492,4960,1255,1140,682,2530,826,2244,789,286,282,154,200,132,181,654,406,636,418
12049,21264,6090,11520,3683,4895,2514,5399,2114,4682,1982,717,722,297,506,420,509,305,416,921,760,9744,3332,2344,1763,5132,2083,4482,1851,650,765,278,508,372,575,1115,930,1153,1074
12051,31587,9203,16868,5753,6356,3526,7984,3549,6088,2823,1896,1869,400,802,1496,1536,540,778,1988,1761,14719,4915,4467,2929,7066,3079,5810,2693,1256,1404,446,723,810,1151,1292,1176,1894,1567
12053,158335,29758,75401,17258,20456,10543,41952,11398,39237,10845,2715,3391,1127,2314,1588,2624,3185,3346,9808,6503,82934,17885,17634,9929,42446,11240,39037,10758,3409,3743,1641,2668,1768,2720,10521,6335,12333,7478
12055,88639,23775,42810,13541,10401,7547,25007,9307,22445,8144,2562,3480,1018,2095,1544,2578,2737,3165,4665,4057,45829,13776,9064,7362,24087,8302,22063,7870,2024,2632,780,1714,1244,2106,6743,4835,5935,4735
12057,1156420,251409,558707,152227,211377,105441,273563,86644,244008,77267,29555,34324,11423,21303,18132,26871,13688,21414,60079,48388,597713,150049,192840,96155,271299,84404,238841,74890,32458,35642,15584,23980,16874,25690,47840,39231,85734,56776
12059,16311,3613,8870,2191,2975,1273,3952,1341,3423,1241,529,460,239,352,290,329,365,437,1578,931,7441,2056,1244,902,4092,1358,3576,1260,516,531,223,341,293,396,1185,761,920,652
12061,133442,32958,63317,19144,18239,11829,35245,11499,32051,10024,3194,4255,870,2172,2324,3556,3197,3757,6636,6000,70125,20565,15824,11148,34143,10915,31265,9844,2878,4019,1195,2553,1683,2897,10320,7723,9838,7817
12063,40665,8734,22541,5421,8690,3404,10044,3584,8131,3114,1913,1326,836,1044,1077,892,853,952,2954,1940,18124,4955,4256,2739,8653,3124,7868,2955,785,883,442,715,343,675,2210,1680,3005,1964
12065,12206,2019,6458,1145,2363,687,3071,894,2624,828,447,279,172,208,275,248,186,264,838,489,5748,1311,1315,835,3232,948,2973,914,259,290,99,205,160,217,587,461,614,501
12067,7167,1982,4383,1222,1925,823,1834,725,1378,604,456,328,248,258,208,150,110,156,514,403,2784,1097,568,508,1435,644,1179,534,256,299,28,87,228,291,498,366,283,339
12069,290768,55899,139381,32967,38444,20022,79964,21016,73692,19723,6272,6844,2305,4166,3967,5206,5317,5643,15656,11270,151387,33376,32477,18103,80057,20834,73309,19534,6748,7715,2819,4639,3929,5705,17848,11511,21005,12924
12071,628913,162950,305473,95781,88010,57730,167140,54736,150105,48279,17035,21349,4516,11312,12519,17949,12957,16180,37366,32100,323440,94478,76760,50417,162671,53716,146146,47015,16525,21607,5501,12093,11024,17497,38593,30173,45416,33861
12073,244782,52385,114521,33079,56072,27188,46449,14277,43179,13355,3270,4685,1246,3258,2024,3953,2145,3701,9855,8318,130261,33334,58746,25900,48358,15012,43074,13410,5284,6153,2303,4065,2981,4780,7748,6629,15409,10214
12075,33817,7760,16333,4505,4589,2686,8309,2836,7514,2622,795,948,314,653,481,725,965,1000,2470,1814,17484,4569,3864,2310,8295,2896,7603,2651,692,876,302,569,390,687,2233,1536,3092,2115
12077,7264,1555,4426,1101,2142,804,1515,541,1156,494,359,255,133,174,226,175,106,116,663,358,2838,872,631,428,1353,455,991,416,362,242,155,193,207,164,255,202,599,412
12079,15593,3543,8319,2081,3634,1344,3303,1270,2812,1146,491,496,223,370,268,373,211,323,1171,806,7274,2036,1912,1134,3253,1274,2888,1204,365,448,124,261,241,380,1037,721,1072,775
12081,325537,71985,156065,42776,45950,26566,85278,25342,77836,22398,7442,9459,2662,5226,4780,7417,6432,7557,18405,14319,169472,41852,38455,22655,85907,24572,77687,22117,8220,9328,3959,6345,4261,6371,18757,13624,26353,17293
12083,298910,66762,141728,38932,41252,24582,77034,23606,70779,22014,6255,7661,2730,4947,3525,5648,6926,7417,16516,13044,157182,40020,36759,22629,78291,23969,70555,22038,7736,8537,3061,5100,4675,6404,20589,13543,21543,14728
12085,137738,29256,67774,18088,20167,11116,36235,11058,32985,10085,3250,3964,1459,2632,1791,2852,2833,3389,8539,6336,69964,17321,14542,9049,34722,10499,31837,9690,2885,3671,1600,2698,1285,2407,9832,6340,10868,7074
12086,2239809,570961,1077157,334609,427902,221623,510871,191597,423624,163165,87247,88716,30832,48649,56415,69588,26686,42678,111698,95146,1162652,336264,386930,203493,496008,181144,400213,153418,95795,89830,45897,58170,49898,62906,107208,87164,172506,117712
12087,66167,16164,34576,9687,10085,5715,17700,6057,15491,5490,2209,2519,674,1467,1535,2137,1144,1658,5647,4006,31591,9089,6872,4817,16793,5774,15196,5329,1597,2057,608,1384,989,1706,2891,2635,5035,3492
12089,69573,12844,34128,7652,8501,4357,20183,5116,18998,4826,1185,1563,391,869,794,1279,1178,1376,4266,2995,35445,7320,6689,3902,21130,5217,19701,4989,1429,1598,598,1000,831,1199,3140,2213,4486,2818
12091,165490,32716,83899,20456,27961,13775,44014,12372,40496,11532,3518,4094,1425,2773,2093,3032,2194,2983,9730,7064,81591,18140,18568,10176,44031,12140,39620,11248,4411,4869,1907,3212,2504,3566,7718,5461,11274,7490
12093,33852,7697,18444,4634,6947,3238,8268,2683,7320,2502,948,949,348,608,600,742,1052,1029,2177,1409,15408,4419,3649,2460,8020,2717,6970,2392,1050,1294,476,813,574,906,1857,1403,1882,1327
12095,1099030,158662,533706,99788,222088,75906,250346,55863,221422,49736,28924,24363,10418,13845,18506,18823,8919,11970,52353,31706,565324,97480,200942,69615,250296,54951,215906,48382,34390,26449,15518,17035,18872,18930,38926,25519,75160,36865
12097,280897,47635,136980,28547,53303,20053,67580,15626,58856,13767,8724,6958,2764,3501,5960,5699,2658,3044,13439,8814,143917,27739,48275,17395,65005,14528,54433,12656,10572,7491,4645,4604,5927,5386,11079,7233,19558,10357
12099,1233187,271977,592069,162185,204273,106413,304402,95607,271478,84975,32924,37656,9998,20225,22926,31495,21294,26519,62100,50001,641118,162689,177183,97031,296954,91888,260886,81408,36068,38533,14249,23250,21819,30010,75780,52139,91201,59858
12101,436815,82376,210302,47957,64199,31481,113447,30095,104881,28412,8566,9973,3959,6983,4607,7531,8605,9286,24051,16559,226513,49686,52549,28544,113380,30492,103891,28306,9489,10833,4442,7464,5047,7868,27428,17170,33156,20005
12103,834529,188373,396766,112191,132359,73633,193137,65255,176468,60095,16669,22538,6292,14582,10377,18450,15194,20025,56076,41432,437763,115298,114354,67032,191061,64512,171120,58268,19941,24942,8643,16290,11298,19270,55255,38989,77093,47755
12105,559959,115396,271621,68709,94001,47147,138247,38722,124610,34900,13637,14731,4931,8569,8706,11712,9827,11284,29546,21404,288338,67553,84288,42243,135801,38027,120516,33714,15285,15902,6666,9552,8619,11809,30305,19957,37944,23688
12107,60206,16869,29397,9649,9348,5799,14234,5888,12620,5492,1614,2124,705,1415,909,1585,1141,1615,4674,3653,30809,9966,7373,5214,14634,5997,12854,5549,1780,2015,974,1595,806,1355,3939,3167,4863,3683
12109,201208,30668,97118,19029,26277,12553,58081,11300,55263,10853,2818,3323,741,1708,2077,2872,2849,3436,9911,6987,104090,18640,23329,11112,57314,11326,53621,10582,3693,4124,1468,2581,2225,3042,9719,6340,13728,7930
12111,261423,62659,126291,36853,40491,23453,66560,21223,60975,19373,5585,7423,1844,4005,3741,5843,4353,5758,14887,11866,135132,37014,34582,21148,65589,20764,58625,18625,6964,7883,2983,4882,3981,5596,15090,10825,19871,13785
12113,143113,28202,73073,17058,21198,10525,41574,10953,38305,10227,3269,3378,1155,2128,2114,2575,1784,2330,8517,6004,70040,15715,14813,8771,40270,10284,37162,9680,3108,3472,1235,2096,1873,2701,6195,4807,8762,5903
12115,370486,71717,174891,41918,43389,24667,101721,27913,94853,26054,6868,8783,2120,5141,4748,7334,8172,8745,21609,15296,195595,43520,37015,22062,100279,27356,92533,25315,7746,9388,2494,5396,5252,7709,27940,16993,30361,17767
12117,381801,76448,182524,45076,62855,30973,97389,27347,91119,25591,6270,8244,2722,5566,3548,6300,4902,6943,17378,14306,199277,46075,56065,29212,97913,26703,90201,25156,7712,9004,3844,6463,3868,6198,16958,12583,28341,17824
12119,117593,13004,58554,7848,10519,4039,38131,5333,34818,4787,3313,2015,1042,1070,2271,1763,3409,2267,6495,3203,59039,7869,5680,3678,36154,5298,34268,4862,1886,1863,572,954,1314,1544,10308,3841,6897,3305
12121,35965,11006,18706,6711,5734,3938,10015,4162,8476,3604,1539,1640,624,1010,915,1174,404,733,2553,2232,17259,5862,3515,2527,8604,3707,7604,3192,1000,1374,491,864,509,937,2590,2116,2550,2185
12123,18212,5035,10314,2819,4189,1620,4686,1874,3810,1734,876,568,245,408,631,487,206,459,1233,885,7898,2916,1561,1376,4329,1949,3858,1766,471,721,232,515,239,518,1079,1055,929,1063
12125,12857,2287,8739,1799,3757,1044,2940,874,1770,702,1170,366,314,199,856,334,253,233,1789,641,4118,930,865,495,2242,691,2045,667,197,211,117,185,80,146,413,301,598,387
12127,458141,91870,221799,55619,72674,38041,110612,32131,101867,29832,8745,10749,2862,6296,5883,8880,9261,10001,29252,19916,236342,55177,58052,32590,109366,31528,99360,28886,10006,11483,4798,7927,5208,8256,29479,18447,39445,23719
12129,26912,5441,14858,3228,5341,2126,6884,2082,5917,1904,967,765,379,551,588,482,473,485,2160,1100,12054,3042,2686,1834,6939,2169,6592,2062,347,497,147,331,200,382,931,758,1498,1009
12131,56582,14072,28685,8407,8137,4898,15909,5474,14520,5047,1389,1711,585,1131,804,1238,881,1343,3758,2895,27897,7840,5118,3660,15774,5379,14467,5041,1307,1729,771,1361,536,1050,2714,2439,4291,3037
12133,20762,3464,11477,2305,4619,1605,4784,1288,4160,1196,624,464,274,331,350,364,507,438,1567,787,9285,1885,1962,1010,4805,1302,4255,1162,550,552,325,455,225,307,1139,680,1379,888
13001,14686,3657,7361,2132,2310,1227,4285,1395,3953,1328,332,360,95,246,237,326,159,303,607,546,7325,2026,1718,1174,3787,1239,3472,1189,315,367,216,302,99,262,996,641,824,678
13003,6396,1314,3149,785,1061,513,1722,538,1520,492,202,194,101,123,101,145,81,95,285,221,3247,741,933,415,1664,457,1400,432,264,220,140,147,124,141,356,239,294,223
13005,8806,2002,4269,1201,1450,742,2169,697,1869,641,300,239,72,141,228,204,134,194,516,405,4537,1125,1095,656,2468,810,2102,714,366,380,286,346,80,191,414,331,560,399
13007,2639,645,1260,397,450,277,678,274,574,243,104,138,70,101,34,76,26,46,106,99,1379,366,372,197,635,265,556,230,79,105,58,86,21,71,246,148,126,108
13009,38049,10802,19197,6553,8648,5144,8099,3143,7131,2832,968,1132,251,570,717,1005,507,776,1943,1696,18852,6188,7649,4401,7104,2710,6245,2445,859,977,520,797,339,689,1786,1367,2313,1890
13011,15252,2100,7579,1291,1874,814,4539,870,4120,807,419,337,173,223,246,241,210,218,956,547,7673,1283,1607,674,4315,868,4019,819,296,286,148,180,148,207,868,449,883,584
13013,61682,8816,29950,5118,8742,3450,17291,3479,15957,3277,1334,1250,567,815,767,911,699,847,3218,1970,31732,5439,7790,3286,16999,3383,15480,3188,1519,1406,887,1061,632,909,2467,1569,4476,2380
13015,83805,19080,40974,10948,11413,6525,23295,6938,21660,6663,1635,1894,614,1169,1021,1441,1182,1523,5084,3887,42831,10697,9346,5580,23177,6959,20985,6500,2192,2458,1102,1597,1090,1629,3399,2730,6909,4437
13017,13518,3934,6235,2270,2524,1618,3005,1342,2608,1161,397,537,316,465,81,261,247,363,459,466,7283,2461,2531,1731,3011,1222,2557,1064,454,565,241,395,213,378,865,663,876,742
13019,15318,3262,7420,1961,1852,1082,4322,1317,4013,1242,309,339,115,269,194,257,264,334,982,738,7898,1887,1680,934,4219,1216,3677,1102,542,530,300,376,242,349,1063,667,936,684
13021,121746,31180,55956,18562,22912,13130,24676,9675,21324,8492,3352,4019,1529,2814,1823,3101,1688,2740,6680,5848,65790,19089,25838,13555,24919,9838,20925,8516,3994,4508,1949,2979,2045,3194,6669,5242,8364,6235
13023,10596,2105,4923,1276,2034,899,2203,669,2060,653,143,186,29,130,114,161,199,272,487,453,5673,1387,2011,1044,2310,707,2047,647,263,305,156,247,107,200,658,419,694,475
13025,15112,3940,7371,2141,2180,1357,3838,1330,3521,1290,317,426,188,303,129,240,325,385,1028,772,7741,2293,1906,1171,3785,1327,3480,1268,305,383,183,294,122,224,1013,712,1037,846
13027,12681,3592,6091,2079,1860,1201,3232,1324,2909,1254,323,418,228,361,95,262,301,420,698,567,6590,2083,1653,1180,3523,1475,3119,1367,404,542,194,350,210,389,755,676,659,573
13029,28055,4138,13827,2615,4164,1789,8206,1706,7921,1696,285,402,144,308,141,291,275,411,1182,846,14228,2346,3164,1373,8306,1667,7644,1594,662,629,354,450,308,389,947,746,1811,1063
13031,63388,14241,30870,8786,15337,6711,12466,4403,11317,4095,1149,1385,566,1027,583,932,521,852,2546,2360,32518,8496,13819,5850,13011,4604,11302,4112,1709,1978,991,1456,718,1104,2445,2087,3243,2554
13033,17630,4115,8252,2326,2410,1500,4848,1625,4284,1554,564,619,144,297,420,530,221,329,773,669,9378,2384,2974,1511,4568,1542,4202,1483,366,420,157,268,209,328,994,789,842,643
13035,19965,4366,10773,2634,4176,1782,5003,1640,3888,1417,1115,710,457,600,658,359,407,483,1187,755,9192,2575,2356,1548,5023,1637,4277,1516,746,756,404,561,342,444,956,800,857,787
13037,5468,946,3396,595,1804,404,977,338,611,271,366,147,85,77,281,142,156,145,459,220,2072,549,632,328,775,282,672,278,103,103,86,100,17,66,359,190,306,206
13039,42302,7183,22021,4787,7612,3214,11563,3020,10860,2851,703,938,340,629,363,669,277,494,2569,1835,20281,3879,4608,2407,11382,2846,10289,2664,1093,1106,624,853,469,662,1439,1167,2852,1830
13043,8469,1854,4107,1085,1315,646,2101,690,1900,653,201,239,162,211,39,118,338,347,353,313,4362,1090,1157,570,2143,698,1862,661,281,284,189,240,92,165,425,306,637,438
13045,94200,20122,45125,12040,14790,7913,24584,7248,22315,6731,2269,2554,1319,1906,950,1440,1129,1672,4622,3546,49075,11704,15230,7565,23285,6699,21358,6314,1927,1929,842,1306,1085,1430,4247,3062,6313,4158
13047,54259,11778,25609,6755,7022,4120,14963,4318,14105,4224,858,1201,374,757,484,928,731,996,2893,2332,28650,7085,5981,4020,15127,4393,14257,4267,870,1177,552,966,318,703,2926,2229,4616,3256
13049,10872,2635,6397,1866,2439,1353,3254,897,2476,804,778,364,290,279,488,219,109,131,595,382,4475,1152,1216,666,2347,722,2032,669,315,255,180,193,135,170,523,366,389,298
13051,236107,56490,112217,34233,45883,24283,51104,18099,45304,15989,5800,7052,1982,4103,3818,5808,3019,4727,12211,10197,123890,33536,43565,21725,52207,18081,45033,15895,7174,7640,3975,5716,3199,5040,11269,9145,16849,12182
13053,8487,1873,5887,1500,3564,1058,1970,851,1432,574,538,524,60,154,478,494,93,185,260,268,2600,765,569,461,1593,524,1390,487,203,227,69,156,134,192,155,199,283,258
13055,20147,4651,10477,2827,3703,1614,5008,1742,4469,1702,539,549,228,405,311,417,323,496,1443,1094,9670,2636,1822,1212,5101,1755,4499,1654,602,700,389,548,213,415,1057,794,1690,1197
13057,197154,36206,95903,21445,26762,13717,59619,13969,56343,13444,3276,3958,1121,2257,2155,3117,1925,2838,7597,6492,101251,21310,22525,12163,60756,14152,56712,13426,4044,4466,1852,2821,2192,3107,6520,5234,11450,7572
13059,107334,21803,50433,14495,28446,12039,18096,6536,16356,6120,1740,2189,756,1538,984,1646,713,1434,3178,2905,56901,13985,29632,11475,18525,6456,16274,5843,2251,2469,1000,1669,1251,1849,3089,2700,5655,3875
13061,2500,426,1230,284,482,224,568,170,486,145,82,92,63,88,19,35,95,93,85,84,1270,283,426,189,516,154,435,129,81,76,59,55,22,37,204,125,124,87
13063,216909,50731,99055,29911,46295,21772,40171,15958,33116,13859,7055,7063,3112,4444,3943,5080,1998,3250,10591,8576,117854,31171,51617,22353,40535,15571,32059,13311,8476,7535,5189,5509,3287,4479,8209,6896,17493,11177
13065,5221,1401,2576,830,1012,646,1186,548,1036,455,150,232,128,219,22,88,44,98,334,340,2645,788,624,423,1306,525,1113,468,193,229,64,137,129,160,378,293,337,295
13067,602852,121874,288540,72816,101897,50125,157273,43227,146830,40570,10443,13454,3559,7994,6884,10582,4877,8128,24493,20706,314312,73027,97376,47662,158860,43219,144381,39761,14479,16013,5704,9543,8775,12239,18241,15882,39835,26522
13069,34274,8713,17720,5320,6960,3246,7641,3006,6371,2597,1270,1223,358,650,912,972,552,758,2567,1844,16554,5034,4566,2898,8364,3069,7375,2922,989,1222,627,907,362,763,1664,1330,1960,1598
13071,35518,9430,17359,5820,6216,3747,8754,3379,7290,2726,1464,1696,420,761,1044,1442,510,773,1879,1672,18159,5344,5095,3055,8749,3268,7288,2695,1461,1612,818,1060,643,994,2289,1668,2026,1675
13073,119095,26853,57786,15787,18296,10384,33204,9398,30260,8011,2944,3667,1118,2032,1826,2636,953,1665,5333,4577,61309,16051,15478,9243,33382,9019,30198,7946,3184,3836,1673,2450,1511,2294,4875,4267,7574,5758
13075,13560,3215,6384,1775,2089,1100,3356,1074,2952,1022,404,453,93,221,311,402,144,246,795,602,7176,1893,1864,1057,3520,1188,3058,1084,462,471,225,288,237,362,844,658,948,694
13077,114253,20625,55090,12537,16668,8654,32581,7923,30679,7403,1902,2405,899,1549,1003,1683,1166,1725,4675,3923,59163,12116,14956,7685,32577,7805,30162,7296,2415,2773,1418,2012,997,1576,4920,3594,6710,4232
13079,10202,2253,5348,1459,2005,1092,2623,821,2375,749,248,268,71,149,177,245,141,187,579,428,4854,1234,1142,707,2511,797,2311,759,200,247,165,225,35,123,469,313,732,483
13081,18198,5514,8535,3249,3283,2255,4011,1775,3590,1649,421,630,307,542,114,333,319,507,922,876,9663,3413,3520,2248,3775,1719,3297,1496,478,715,253,506,225,463,1327,1068,1041,849
13083,13629,2284,6560,1342,1715,778,3871,927,3631,891,240,249,136,185,104,163,197,209,777,537,7069,1322,1576,686,3843,894,3582,870,261,303,175,243,86,150,785,481,865,515
13085,20507,3769,10132,2308,2935,1452,5874,1503,5238,1337,636,681,208,329,428,545,315,398,1008,722,10375,2106,1987,1135,6263,1632,5793,1526,470,532,82,190,388,484,711,545,1414,940
13087,21271,5764,10152,3238,3745,2115,5129,1935,4469,1841,660,608,280,456,380,442,326,436,952,819,11119,3427,3087,2021,5534,2184,4884,2038,650,794,405,622,245,477,1357,1088,1141,961
13089,600889,130885,278776,80478,126407,61329,120969,42131,105538,37453,15431,17129,5592,9915,9839,13356,5720,9470,25680,22081,322113,81240,133026,58242,123037,42127,105752,37296,17285,17597,8582,12106,8703,12414,23160,19399,42890,28345
13091,17416,4601,9100,2909,3435,1814,4270,1592,3609,1445,661,595,192,301,469,519,306,339,1089,824,8316,2477,1867,1188,4231,1467,3656,1413,575,528,408,445,167,291,914,725,1304,981
13093,11796,2885,6479,1859,2599,1249,2981,1128,2353,996,628,524,428,442,200,242,204,244,695,410,5317,1575,1634,905,2296,882,2002,800,294,301,168,220,126,206,864,536,523,479
13095,71621,18754,32152,11590,14263,8530,12830,5349,10742,4589,2088,2577,1218,1999,870,1540,1132,1646,3927,3298,39469,11124,16315,7921,13628,5431,10906,4664,2722,2801,1838,2277,884,1575,4090,3114,5436,3701
13097,112848,23860,52742,14157,18854,9721,26758,8103,23949,7553,2809,2964,1171,1774,1638,2159,1326,1856,5804,4495,60106,14427,19083,9320,27924,8325,24370,7637,3554,3447,1882,2379,1672,2248,4222,3535,8877,5849
13099,8175,2278,3718,1265,1477,813,1656,698,1510,646,146,236,54,167,92,212,218,279,367,345,4457,1388,1528,895,1613,710,1460,685,153,224,129,216,24,161,663,432,653,556
13101,3304,626,1647,383,354,212,1009,272,861,220,148,141,29,56,119,130,48,65,236,175,1657,363,329,197,927,223,810,204,117,121,35,57,82,106,187,124,214,119
13103,47197,7998,23065,4807,6497,3103,13157,2863,12412,2817,745,794,152,407,593,714,706,855,2705,1691,24132,4702,5535,2813,13762,2985,12779,2857,983,1098,384,632,599,787,1892,1284,2943,1809
13105,15670,4175,7490,2502,2564,1653,3712,1500,3394,1423,318,480,168,368,150,351,308,447,906,806,8180,2407,2048,1367,3852,1510,3384,1393,468,624,332,505,136,359,984,806,1296,929
13107,17796,4345,8734,2607,3640,1878,3774,1408,3393,1318,381,443,205,376,176,293,276,328,1044,780,9062,2552,2688,1460,4138,1508,3623,1383,515,589,392,493,123,295,952,665,1284,901
13109,8295,1948,3938,1155,1355,786,1942,710,1766,671,176,210,95,184,81,148,131,194,510,401,4357,1170,1282,705,1926,739,1603,628,323,335,136,205,187,261,590,432,559,378
13111,21919,5567,10497,2964,1991,1407,6343,2100,6085,2075,258,442,110,306,148,355,525,645,1638,1220,11422,3272,2024,1508,6182,2117,5758,1990,424,612,125,327,299,500,1769,1371,1447,1101
13113,91954,15689,43929,9136,11706,5937,28314,5936,26823,5763,1491,1788,587,1137,904,1348,971,1182,2938,2541,48025,9533,11074,5919,28304,5927,26670,5772,1634,1781,538,1052,1096,1461,3874,2787,4773,3229
13115,78639,16565,37465,9710,11965,6359,20351,6010,18565,5534,1786,2154,840,1483,946,1409,1158,1565,3991,2934,41174,9890,11436,6147,20397,5951,18471,5449,1926,2069,1091,1554,835,1340,3995,2864,5346,3547
13117,176495,27342,86849,16306,21238,10397,59000,10840,56853,10397,2147,2822,549,1785,1598,2501,1221,2051,5390,4309,89646,15321,18688,9131,57542,10474,55048,10045,2494,2986,623,1789,1871,2652,5080,3851,8336,5482
13119,18642,4156,8956,2343,2781,1469,5076,1522,4755,1479,321,399,152,289,169,308,244,300,855,665,9686,2469,2098,1306,5166,1568,4627,1436,539,532,352,412,187,315,1089,707,1333,856
13121,845579,185501,404776,113912,190514,88466,170356,56908,153057,51187,17299,20942,6100,12297,11199,16515,8920,14230,34986,30387,440803,117384,186296,86632,167989,55862,149425,50002,18564,22102,8694,14678,9870,16027,30054,25572,56464,38859
13123,25614,5815,12765,3446,2827,1655,7764,2393,6743,2056,1021,1028,545,715,476,679,458,524,1716,1234,12849,3359,2222,1716,7494,2130,6866,2028,628,725,293,446,335,500,1212,913,1921,1257
13125,2460,413,1099,248,337,142,586,174,561,168,25,41,8,41,17,34,16,47,160,90,1361,246,430,177,591,165,523,156,68,67,15,43,53,59,164,91,176,96
13127,69000,16400,31986,9837,9879,5995,16825,5755,15687,5402,1138,1805,299,1000,839,1559,1157,1624,4125,3576,37014,9853,9673,5876,17667,5936,15939,5572,1728,2094,937,1515,791,1378,3781,2809,5893,3983
13129,45777,10520,22370,6164,6463,3678,12370,3846,11611,3710,759,992,353,704,406,706,955,1100,2582,2098,23407,6179,5189,3378,12675,3816,11001,3443,1674,1605,938,1137,736,999,2643,1854,2900,1984
13131,19720,4589,9362,2744,2878,1692,5244,1768,4583,1467,661,750,259,464,402,532,272,425,968,849,10358,2751,2441,1588,5243,1749,4802,1552,441,556,275,474,166,346,1198,913,1476,1103
13133,14569,3251,7061,1918,2140,1225,4180,1247,3864,1167,316,391,162,297,154,315,218,314,523,460,7508,1854,1841,1109,4030,1241,3684,1121,346,474,205,353,141,329,898,628,739,598
13135,711376,141873,343815,83604,122688,57162,191293,49716,176396,46294,14897,16389,4225,7947,10672,13601,5348,8435,24486,20815,367561,83609,114487,55102,190639,48158,171967,44639,18672,18162,7871,11081,10801,13270,21064,18319,41371,26704
13137,36392,8134,16953,4549,4920,2632,9487,2770,9021,2648,466,663,179,430,287,572,881,974,1665,1362,19439,4682,4868,2418,9830,2960,8466,2586,1364,1216,320,480,1044,1117,2006,1477,2735,1673
13139,156768,29805,77241,17798,25818,11856,42874,10694,39054,9718,3820,4020,1057,1989,2763,3375,1564,2226,6985,5189,79527,17421,22071,10508,41940,10505,37478,9321,4462,4323,1790,2496,2672,3341,6478,4629,9038,5657
13141,7539,1911,4332,1450,2491,942,1327,656,949,563,378,277,122,172,256,207,119,156,395,236,3207,1032,1058,674,1425,626,1042,563,383,361,207,301,176,211,471,324,253,243
13143,23351,5289,11241,2983,2724,1589,6585,2116,6053,2023,532,642,182,392,350,492,544,736,1388,1124,12110,3078,2567,1593,6173,2018,5583,1924,590,604,476,551,114,273,1484,993,1886,1310
13145,28135,5694,13922,3167,3626,1757,8703,2002,8333,1958,370,450,185,308,185,327,407,525,1186,882,14213,3223,2912,1708,8749,2083,8252,1997,497,523,127,259,370,478,1138,872,1414,1035
13147,21276,5444,10408,3154,3087,1889,5629,1939,5341,1866,288,475,78,307,210,390,371,566,1321,1140,10868,3289,2426,1603,5546,1864,5111,1755,435,516,173,354,262,432,1289,1040,1607,1253
13149,9576,1854,4633,1005,1071,558,2771,765,2557,758,214,219,84,136,130,183,208,202,583,369,4943,1111,967,490,2574,740,2378,704,196,180,124,146,72,143,508,330,894,510
13151,178662,32667,83715,18913,28279,12804,47234,11530,44219,11013,3015,3411,951,1772,2064,2772,1279,1846,6923,4999,94947,20042,29507,13456,47296,11532,42860,10620,4436,4317,2326,2884,2110,2776,6187,4612,11957,7053
13153,120666,27866,57729,16093,19552,11100,31389,9575,29766,9196,1623,2449,974,1946,649,1537,1288,2104,5500,4902,62937,16594,17746,10707,32067,9711,29067,9012,3000,3508,1790,2621,1210,2099,5130,4107,7994,5609
13155,7663,2136,4003,1372,1472,897,2083,911,1815,766,268,325,169,268,99,206,82,149,366,376,3660,1213,1197,811,1547,608,1400,606,147,190,68,123,79,150,444,321,472,423
13157,53594,9467,26250,5439,6701,3198,16133,3733,14730,3294,1403,1573,480,796,923,1202,588,759,2828,2028,27344,5353,5969,3055,15537,3574,14284,3230,1253,1225,683,854,570,802,2584,1720,3254,1994
13159,11179,1961,5330,1077,1305,566,3147,796,2950,754,197,233,51,114,146,211,234,216,644,402,5849,1165,1173,578,3255,774,2923,736,332,304,201,233,131,194,507,317,914,487
13161,11659,3564,5602,1926,1443,1099,3068,1338,2870,1272,198,346,85,237,113,246,251,289,840,733,6057,2147,1709,1168,2946,1273,2469,1082,477,561,299,408,178,317,600,611,802,783
13163,12597,3599,5998,2122,2497,1498,2634,1143,2261,1033,373,417,126,247,247,387,145,256,722,603,6599,2138,2280,1378,2449,1050,2111,981,338,391,189,310,149,285,997,707,873,742
13165,7033,2487,3037,1308,857,801,1658,823,1608,815,50,141,17,109,33,126,161,279,361,422,3996,1522,1021,722,1819,862,1517,784,302,371,274,347,28,119,421,432,735,590
13167,8177,2669,4702,2085,2130,1392,1776,772,1536,649,240,324,68,132,172,275,240,260,556,451,3475,898,1089,549,1453,521,1197,479,256,232,167,186,89,152,442,308,491,319
13169,23162,3707,11080,2198,2839,1356,6480,1590,5987,1478,493,487,73,206,420,449,439,442,1322,779,12082,2142,2755,1296,6410,1449,5628,1354,782,688,249,321,533,596,1031,651,1886,932
13171,15527,4372,7400,2435,2739,1696,3415,1351,2814,1187,601,657,220,376,381,472,274,390,972,780,8127,2698,2771,1698,3641,1437,2959,1244,682,707,181,293,501,615,860,634,855,747
13173,8202,2001,4078,1176,1243,678,2371,840,2122,816,249,241,85,176,164,207,16,88,448,381,4124,1184,1077,691,2077,819,1969,814,108,174,26,109,82,156,409,385,561,483
13175,37620,8954,17308,5379,6321,3660,8485,2747,7510,2466,975,1077,484,760,491,794,652,820,1850,1514,20312,5218,6233,3103,8778,2949,7732,2572,1046,1225,493,810,553,897,2526,1820,2775,1930
13177,23072,4101,11497,2355,3565,1674,6670,1672,6098,1483,572,645,233,407,339,403,328,379,934,654,11575,2466,2696,1443,6743,1572,6266,1523,477,522,263,372,214,349,845,677,1291,911
13179,46224,8565,23339,5209,7701,3506,13094,3598,11727,3397,1367,1210,573,777,794,884,316,548,2228,1607,22885,4911,5893,3063,12429,3294,10766,3107,1663,1354,549,711,1114,1103,1711,1328,2852,1686
13181,6537,1297,3090,774,766,436,1764,563,1615,552,149,160,125,150,24,86,140,164,420,318,3447,782,861,442,1603,527,1478,505,125,155,97,142,28,104,488,294,495,312
13183,14221,3293,7237,1833,2115,1197,3816,1242,3324,1224,492,522,133,244,359,421,215,292,1091,673,6984,2116,1590,1104,3462,1205,2644,928,818,718,504,564,314,332,660,492,1272,896
13185,91873,22351,44246,13639,19185,10288,19756,6843,17808,6283,1948,2402,916,1683,1032,1656,1008,1570,4297,3860,47627,13352,17419,9770,20439,6872,18115,6339,2324,2611,1216,1785,1108,1789,4055,3257,5714,4129
13187,27555,5613,13333,3819,4926,2987,6489,1780,6056,1731,433,530,95,243,338,462,537,564,1381,1148,14222,3041,4343,1964,6705,1852,6184,1781,521,592,139,258,382,507,1441,925,1733,1059
13189,17056,4749,7777,2722,2541,1775,3950,1659,3566,1489,384,549,99,296,285,470,335,474,951,921,9279,2953,3043,1909,4363,1744,3827,1592,536,690,220,400,316,545,1003,862,870,809
13191,12240,3313,5994,1960,1680,1071,3363,1328,3102,1280,261,372,98,227,163,302,219,349,732,575,6246,1845,1344,856,3336,1313,3065,1250,271,382,133,284,138,263,1011,807,555,446
13193,11289,2660,6224,1724,3012,1272,2380,961,1967,889,413,370,181,276,232,273,185,284,647,548,5065,1575,1961,1045,2127,874,1712,791,415,425,223,330,192,273,534,459,443,429
13195,23558,4553,11478,2692,3255,1588,6695,1844,6208,1707,487,582,231,401,256,375,327,457,1201,896,12080,2686,2598,1513,6874,1932,6354,1754,520,608,245,405,275,423,1438,911,1170,922
13197,6970,1404,3411,799,1000,470,1866,537,1701,509,165,167,86,125,79,104,120,132,425,290,3559,792,887,459,2005,551,1833,526,172,181,156,177,16,64,437,287,230,199
13199,17337,5168,8289,2953,2936,1811,4297,1841,3730,1682,567,709,255,449,312,523,233,403,823,830,9048,3079,2807,1650,3663,1665,3038,1430,625,736,361,526,264,503,1147,862,1431,1277
13201,4722,723,2226,442,671,284,1242,308,1145,313,97,97,52,81,45,67,70,99,243,168,2496,421,647,269,1248,312,1124,304,124,117,77,97,47,82,336,169,265,157
13205,18003,4331,9268,2661,3742,1674,4035,1589,3293,1482,742,544,308,372,434,410,149,285,1342,952,8735,2572,2863,1693,3532,1416,3067,1313,465,482,355,404,110,287,901,744,1439,964
13207,22577,5013,11202,2980,3521,1953,5936,1600,5161,1496,775,676,240,354,535,540,427,520,1318,998,11375,2902,2727,1586,5909,1716,5164,1559,745,717,357,447,388,540,1458,957,1281,1017
13209,7600,1312,3876,814,1248,448,1885,531,1582,473,303,235,109,144,194,177,156,136,587,334,3724,729,1020,454,1813,493,1599,479,214,214,54,102,160,187,440,228,451,257
13211,15066,2572,7168,1536,2069,1055,4411,1006,4131,957,280,299,105,173,175,250,112,176,576,468,7898,1542,1969,1060,4372,1068,4020,938,352,350,199,274,153,209,751,451,806,500
13213,31558,7779,15536,4349,4089,2428,8942,2907,8477,2792,465,724,318,620,147,444,503,698,2002,1547,16022,4441,2912,2092,9338,3031,8355,2748,983,1079,588,787,395,688,1724,1306,2048,1456
13215,154743,35134,74515,21858,30857,15930,32965,11228,28529,9874,4436,4682,2090,3270,2346,3121,2449,3452,8244,6777,80228,21052,27338,13995,32808,11050,27953,9658,4855,5007,2516,3327,2339,3485,7919,5793,12163,7862
13217,84981,16293,39460,9402,14183,6710,19851,5311,18342,5042,1509,1622,809,1153,700,1037,779,1017,4647,3158,45521,9797,15212,6516,20448,5522,18778,5211,1670,1801,765,1083,905,1246,3178,2368,6683,3600
13219,29949,4802,14540,2848,3562,1784,9590,1903,9250,1833,340,402,146,279,194,308,329,402,1059,885,15409,2800,3245,1658,9117,1731,8856,1710,261,322,115,231,146,255,1111,814,1936,1102
13221,12098,2294,5963,1285,1819,823,3201,853,2982,820,219,271,72,145,147,230,244,260,699,482,6135,1377,1217,658,3193,882,2867,796,326,340,188,258,138,195,802,556,923,560
13223,125040,23428,60182,13686,18136,8578,33863,8418,32096,7953,1767,2158,493,1068,1274,1804,1516,2044,6667,4866,64858,13882,16027,7938,35299,8488,32188,7873,3111,3166,1132,1743,1979,2501,4415,3333,9117,5941
13225,22377,4315,10807,2686,4566,1854,4638,1491,4163,1314,475,567,280,375,195,340,387,433,1216,890,11570,2581,4191,1750,4365,1363,3717,1224,648,598,463,527,185,281,1756,1040,1258,836
13227,26168,5731,12818,3278,3139,1787,7676,2303,7182,2164,494,589,84,291,410,570,383,506,1620,1176,13350,3275,2401,1590,8034,2279,7592,2187,442,579,212,398,230,388,1259,1092,1656,1178
13229,15225,3301,7497,2040,2216,1278,4392,1354,3723,1218,669,562,516,478,153,300,154,234,735,681,7728,1853,1806,1050,4248,1289,3695,1209,553,465,446,433,107,205,724,530,950,783
13231,14892,2382,7158,1438,1997,879,4199,866,3683,795,516,466,98,170,418,405,321,331,641,476,7734,1414,1855,831,4362,933,3866,840,496,411,94,160,402,365,864,518,653,456
13233,32893,10425,16082,6220,5047,3894,7959,3503,7197,3225,762,1125,171,541,591,1010,755,1003,2321,2128,16811,5695,4523,3068,8078,3443,6992,3053,1086,1410,399,765,687,1110,1686,1578,2524,2102
13235,9731,3321,4366,1626,1402,973,1983,750,1778,652,205,276,27,125,178,255,280,317,701,661,5365,2100,1862,1134,2029,723,1672,634,357,242,93,148,264,220,662,550,812,626
13237,18014,4852,8727,2813,2391,1724,5076,1821,4864,1740,212,404,126,323,86,291,177,334,1083,971,9287,2746,2158,1490,5212,1862,4748,1782,464,646,302,540,162,363,1139,896,778,832
13239,1903,364,911,220,383,165,425,127,372,122,53,45,22,33,31,36,67,64,36,31,992,214,278,137,469,141,360,127,109,68,90,62,19,30,149,84,96,59
13241,14413,2809,7124,1684,2057,1016,3824,1100,3404,988,420,437,155,281,265,338,375,380,868,590,7289,1632,1489,847,3744,1088,3433,990,311,374,134,236,177,318,1000,579,1056,631
13243,5464,1795,2636,1016,967,628,1008,565,839,502,169,227,86,169,83,148,165,220,496,406,2828,1024,1057,712,998,535,764,465,234,228,189,208,45,125,441,355,332,330
13245,162672,43909,77579,26628,37153,19673,29174,11970,24193,10135,4981,5362,2093,3455,2888,3940,2275,3408,8977,7875,85093,26534,32428,18262,31258,12894,25761,10785,5497,6175,3034,4470,2463,3962,8845,7169,12562,8843
13247,71633,16621,33077,9490,11978,6353,17344,5899,15972,5567,1372,1725,448,976,924,1380,755,1148,3000,2720,38556,10218,12428,6537,17270,5812,15348,5275,1922,2231,706,1159,1216,1748,3129,2485,5729,3911
13249,4217,621,2130,411,719,303,1149,220,1128,223,21,44,21,44,0,39,56,70,206,153,2087,356,556,231,1133,213,1059,201,74,74,51,55,23,34,207,122,191,121
13251,11521,3006,5513,1684,1924,1072,2641,975,2372,888,269,340,70,215,199,290,214,271,734,550,6008,1836,1761,1135,2939,1047,2473,900,466,502,265,349,201,332,716,514,592,482
13253,6882,1773,3164,1012,1033,587,1595,622,1456,588,139,203,59,159,80,163,131,192,405,324,3718,1083,1152,714,1475,583,1342,549,133,202,106,187,27,127,578,389,513,359
13255,52471,12088,24899,7133,9025,5017,11904,4004,10536,3629,1368,1492,692,1086,676,992,784,1042,3186,2417,27572,7138,8076,4381,12049,3993,10375,3454,1674,1801,997,1260,677,1091,2725,1913,4722,3026
13257,21082,6414,9620,3334,2496,1738,5789,2251,5311,2190,478,615,244,429,234,431,241,460,1094,1071,11462,3923,2867,1900,6045,2444,5349,2249,696,857,390,598,306,560,1322,1208,1228,1130
13259,5742,1144,3879,801,1979,605,1542,412,597,298,945,261,186,215,759,200,57,77,301,230,1863,560,625,422,777,368,671,349,106,126,80,111,26,77,308,189,153,139
13261,24281,6836,11282,3807,4841,2658,4864,2155,4381,2033,483,649,235,518,248,459,395,565,1182,1125,12999,4287,4935,2946,5193,2327,4656,2145,537,785,394,696,143,405,1478,1198,1393,1195
13263,5436,981,2584,545,792,323,1350,380,1184,344,166,144,103,117,63,105,176,165,266,199,2852,615,858,391,1255,349,1138,351,117,107,74,94,43,81,439,248,300,186
13265,1426,314,744,215,346,183,321,104,270,97,51,44,14,22,37,36,11,26,66,47,682,161,236,98,291,101,254,80,37,50,26,47,11,32,81,49,74,47
13267,21047,3856,12692,2290,5848,1338,4928,1567,3767,1427,1161,524,412,361,749,402,327,315,1589,774,8355,2171,1356,885,4553,1653,4203,1602,350,376,236,332,114,229,1082,804,1364,954
13269,6776,1587,3202,914,1185,607,1630,671,1485,651,145,179,102,155,43,132,108,151,279,270,3574,946,1167,498,1760,648,1508,609,252,268,221,237,31,104,360,252,287,231
13271,13901,3480,8280,2142,4490,1740,2847,1090,2074,959,773,473,124,189,649,422,214,284,729,570,5621,1904,2092,1328,2268,1037,2090,987,178,272,102,217,76,170,650,493,611,579
13273,7058,1687,3287,970,1334,672,1509,587,1293,538,216,228,144,211,72,151,185,206,259,236,3771,1043,1307,673,1588,610,1363,568,225,242,183,232,42,129,471,327,405,320
13275,35826,8926,16694,5177,5402,3394,8853,3210,8023,2856,830,1082,539,926,291,636,416,681,2023,1685,19132,5515,5005,3280,9110,3330,7823,2783,1287,1526,870,1299,417,731,2032,1529,2985,2170
13277,32109,8418,15252,5148,6152,3499,7597,2873,7019,2669,578,852,250,608,328,646,409,653,1094,1157,16857,4957,5403,2991,8003,3082,7148,2714,855,1189,369,762,486,870,1705,1449,1746,1409
13279,20990,6592,9793,3873,2967,2350,5394,2494,4585,2238,809,1046,348,642,461,757,434,640,998,1028,11197,3835,3010,2223,5207,2467,4449,2121,758,992,358,666,400,653,1335,1149,1645,1376
13281,10462,2029,4880,1069,1354,684,2833,742,2692,713,141,179,42,126,99,147,217,218,476,343,5582,1221,1243,645,2956,788,2859,773,97,138,36,115,61,122,775,403,608,406
13283,5574,1729,2891,1082,995,595,1515,656,1264,601,251,255,164,209,87,126,96,144,285,284,2683,895,626,419,1364,571,1211,567,153,174,83,146,70,132,291,238,402,272
13285,55531,12876,26128,7402,9840,5113,12845,4242,11490,3863,1355,1448,698,1053,657,972,679,937,2764,2261,29403,8124,9280,5185,13612,4541,11904,4045,1708,1914,1109,1552,599,1020,3192,2343,3319,2449
13287,6330,1862,3041,1055,956,628,1576,740,1375,688,201,256,26,105,175,253,88,176,421,349,3289,1109,930,638,1727,721,1519,689,208,262,127,233,81,166,382,333,250,302
13289,6889,1963,3325,1202,1079,683,1589,718,1365,643,224,274,136,235,88,163,247,275,410,389,3564,1137,961,679,1610,646,1472,640,138,170,93,148,45,125,555,405,438,332
13291,20207,4263,9763,2400,2155,1320,6129,1664,5776,1643,353,352,105,239,248,316,403,439,1076,755,10444,2428,1294,869,6466,1815,6060,1734,406,507,230,377,176,325,1351,856,1333,862
13293,21171,5258,9938,3008,3414,2036,4886,1663,4398,1551,488,649,218,413,270,505,471,613,1167,948,11233,3209,2879,1920,5182,1713,4467,1618,715,807,367,557,348,554,1407,1004,1765,1268
13295,56751,14270,27683,8125,7696,4974,15403,5143,14025,4747,1378,1680,533,1033,845,1280,930,1252,3654,2917,29068,8496,6100,4158,14944,5076,13605,4699,1339,1696,712,1197,627,1157,3883,3055,4141,3299
13297,72738,12984,34923,7751,10429,5175,20641,4835,18806,4443,1835,1856,625,982,1210,1485,852,1103,3001,2322,37815,7754,9848,5136,20109,4601,18355,4247,1754,1833,742,1118,1012,1317,3524,2366,4334,2692
13299,28691,8709,14344,5189,5220,2973,6803,3274,5870,2870,933,1190,429,862,504,809,470,679,1851,1519,14347,5129,3927,2867,6975,3165,6340,2984,635,865,371,684,264,600,1711,1383,1734,1627
13301,4360,926,2026,531,747,329,944,380,849,353,95,124,7,67,88,126,72,99,263,192,2334,577,751,353,940,364,787,337,153,124,122,122,31,66,333,203,310,217
13303,16815,3417,8621,2206,3570,1555,3907,1344,3194,1165,713,586,328,435,385,370,196,316,948,758,8194,1971,2373,1192,3514,1132,2919,1037,595,528,433,473,162,257,1426,853,881,643
13305,23610,6257,11954,3543,3828,2086,6127,2247,5109,1976,1018,853,408,588,610,616,348,523,1651,1095,11656,3610,2677,1865,6320,2395,5627,2245,693,823,375,576,318,592,1421,1176,1238,1044
13307,2101,243,1009,187,269,145,643,126,551,116,92,63,73,58,19,35,47,55,50,44,1092,164,228,115,560,115,504,103,56,47,47,44,9,25,132,76,172,87
13309,6914,2414,4397,1898,2357,1499,1547,765,1206,591,341,391,186,269,155,236,50,83,443,428,2517,1040,904,667,903,446,724,381,179,196,114,134,65,128,292,234,418,396
13311,24914,4824,12116,2770,2840,1461,7572,2003,7130,1954,442,531,58,188,384,495,464,521,1240,930,12798,2753,2562,1371,7279,1977,6851,1937,428,544,211,365,217,355,1384,904,1573,1087
13313,81659,24442,40284,14073,12838,8312,21921,8805,19545,7903,2376,3113,736,1512,1640,2560,1353,2140,4172,3760,41375,13439,9672,6639,21983,8507,19158,7579,2825,3484,1415,2096,1410,2371,4393,3787,5327,4238
13315,7391,848,4532,583,2125,495,1620,386,1250,358,370,139,90,77,280,144,90,109,697,236,2859,499,646,271,1449,339,1286,320,163,150,105,122,58,98,434,202,330,199
13317,8174,2007,3846,1178,1329,724,1801,671,1638,635,163,231,98,173,65,177,184,228,532,415,4328,1162,1440,777,1738,634,1583,601,155,190,106,173,49,144,628,397,522,424
13319,7299,1447,3436,813,1165,504,1545,465,1370,442,175,157,90,119,85,121,144,139,582,381,3863,883,1237,554,1747,550,1497,486,250,236,144,159,106,157,467,311,412,251
13321,16671,3854,7932,2279,2237,1461,4539,1470,4238,1432,301,393,243,352,58,220,218,300,938,745,8739,2230,1898,1155,4658,1507,4134,1334,524,619,278,411,246,401,834,636,1349,971
15001,163114,39117,80351,21822,29220,14194,40702,13372,36367,12274,4335,4504,1393,2405,2942,3667,2444,3236,7985,6243,82763,22589,23975,12956,40971,13603,36471,12432,4500,4581,1396,2463,3104,3612,7986,6224,9831,6982
15003,807474,161333,404881,95184,155880,65009,209029,56794,184244,50499,24785,22640,4267,9596,20518,20431,9752,12452,30220,23884,402593,92683,117917,54839,204806,55164,179839,49166,24967,22510,5154,10225,19813,19704,41042,26755,38828,26736
15005,65,27,29,18,9,16,10,17,7,18,3,14,0,22,3,14,0,22,10,17,36,27,15,19,14,16,9,16,5,14,0,22,5,14,7,18,0,22
15007,58505,14290,28706,8100,10206,5038,14744,4936,12902,4308,1842,2011,236,752,1606,1888,1094,1344,2662,2201,29799,7979,8758,4626,14772,4796,13027,4316,1745,1906,416,926,1329,1680,2797,2255,3472,2389
15009,135627,33416,66871,18578,23939,11575,35000,11534,31148,10515,3852,3793,803,1728,3049,3339,1468,2176,6464,4909,68756,18995,19599,10522,34815,11600,30228,10288,4587,4554,1207,2200,3380,3739,6311,4884,8031,5675
16001,366785,62403,182958,39584,61371,28091,97863,22963,90851,21653,7012,7511,1770,3603,5242,6333,3538,5005,20186,13512,183827,36761,49806,24519,96061,22857,89911,21400,6150,6973,1508,3425,4642,6156,12082,9428,25878,15476
16003,3523,426,1826,245,345,106,1105,233,1031,216,74,64,6,31,68,65,78,65,298,139,1697,253,198,108,1066,206,1028,206,38,41,5,32,33,37,249,113,184,97
16005,66979,13349,33170,8142,11231,5734,17175,4751,16014,4472,1161,1573,342,974,819,1366,869,1213,3895,2910,33809,8025,8964,4815,17757,4919,16333,4536,1424,1768,574,1142,850,1378,2354,1989,4734,3183
16007,4705,768,2323,446,455,253,1610,339,1551,335,59,79,12,74,47,73,62,92,196,126,2382,452,353,225,1598,348,1542,346,56,84,31,68,25,71,220,152,211,139
16009,7449,1396,3759,800,1110,537,1942,497,1880,493,62,90,39,84,23,82,148,137,559,309,3690,781,744,340,2010,522,1850,500,160,142,63,98,97,117,332,219,604,355
16011,34005,8184,16888,4782,4405,2760,10045,3287,9268,2914,777,1092,67,385,710,1045,518,760,1920,1565,17117,4588,3958,2454,9734,3011,9211,2810,523,816,140,453,383,720,1315,1193,2110,1620
16013,18351,4385,9424,2638,2982,1700,5566,1772,5044,1689,522,601,39,206,483,574,204,325,672,700,8927,2596,1960,1275,5068,1691,4256,1449,812,889,66,196,746,852,489,558,1410,1080
16015,6425,919,3254,486,683,288,2064,394,1994,391,70,80,40,64,30,51,128,125,379,207,3171,561,529,271,1981,373,1945,373,36,49,7,37,29,54,208,163,453,218
16017,36518,8717,18155,5025,3933,2494,11182,3500,10425,3316,757,1011,236,572,521,821,659,965,2381,1851,18363,4957,3051,2072,11151,3414,10269,3215,882,1118,241,584,641,948,1792,1501,2369,1699
16019,84655,15351,41955,9404,11399,5799,25039,6186,23481,5764,1558,1968,605,1333,953,1499,1028,1511,4489,3364,42700,8705,9076,5051,24572,6035,23034,5706,1538,1903,641,1289,897,1455,3231,2364,5821,3724
16021,9581,2240,4724,1258,1298,761,2667,853,2483,813,184,248,43,136,141,210,128,214,631,461,4857,1370,970,601,2715,892,2489,846,226,273,5,94,221,270,494,358,678,487
16023,2040,353,1062,244,235,156,643,166,544,147,99,98,34,41,65,85,57,54,127,95,978,204,171,113,597,152,536,143,61,73,3,30,58,73,131,82,79,62
16025,811,94,392,70,96,48,227,49,219,47,8,12,8,12,0,12,0,12,69,36,419,71,62,39,209,40,206,41,3,5,3,5,0,12,91,58,57,27
16027,165278,30120,81165,17882,25997,11775,43582,10793,39848,9866,3734,4166,994,1876,2740,3452,1842,2351,9744,6587,84113,17440,22336,10860,44873,10842,41114,10227,3759,4037,1537,2304,2222,2993,5636,4166,11268,6739
16029,5296,994,2709,574,672,334,1593,403,1504,384,89,128,34,110,55,103,79,112,365,247,2587,574,366,239,1755,427,1729,424,26,85,5,80,21,89,292,202,174,155
16031,17371,3995,8814,2512,2458,1456,5288,1503,4990,1465,298,407,49,252,249,366,189,286,879,781,8557,2147,1788,1231,5300,1483,4993,1402,307,433,121,315,186,333,586,493,883,702
16033,708,107,375,82,128,49,203,54,163,45,40,34,0,12,40,34,8,7,36,27,333,51,89,49,200,54,197,53,3,5,0,12,3,5,14,14,30,31
16035,7593,1422,4225,961,1205,614,1964,558,1769,520,195,178,36,138,159,180,219,210,837,416,3368,702,567,337,2009,545,1910,530,99,170,35,142,64,167,308,230,484,318
16037,3660,965,1866,566,530,322,1038,399,1001,393,37,68,5,49,32,67,61,117,237,193,1794,509,305,173,1044,385,1001,386,43,75,13,51,30,59,208,190,237,179
16039,20993,3986,11127,2585,3083,1484,6697,1792,6055,1684,642,678,381,555,261,362,296,396,1051,798,9866,2135,1778,1029,6090,1628,5558,1523,532,515,204,370,328,354,824,654,1174,798
16041,9902,2432,5009,1324,1290,727,3161,859,3023,855,138,210,5,120,133,209,128,187,430,411,4893,1402,1108,838,3108,877,3011,846,97,181,92,186,5,105,361,337,316,301
16043,10289,2354,5399,1341,1304,689,3480,944,3296,925,184,242,45,174,139,212,150,199,465,373,4890,1288,844,518,3176,876,2992,849,184,228,131,221,53,150,399,368,471,437
16045,14065,3171,6902,1823,1870,1162,3730,1223,3586,1195,144,243,28,155,116,227,381,419,921,722,7163,1878,1448,936,3800,1197,3538,1137,262,386,96,239,166,292,873,604,1042,806
16047,11730,2740,6036,1803,1691,1101,3417,1122,3139,1060,278,376,67,178,211,325,159,245,769,543,5694,1505,1344,846,2985,990,2863,974,122,185,57,178,65,154,606,506,759,573
16049,13763,2742,7255,1731,1720,946,4229,1138,3986,1077,243,284,82,187,161,255,303,380,1003,623,6508,1476,1008,703,4066,1104,3832,1036,234,360,75,222,159,298,775,553,659,460
16051,20508,4018,10433,2430,2917,1453,6491,1610,6273,1573,218,370,81,234,137,300,54,170,971,700,10075,2076,2004,1101,6818,1559,6489,1560,329,417,181,291,148,281,514,489,739,569
16053,17490,3643,8821,2303,2612,1390,5116,1632,4426,1339,690,807,42,206,648,785,223,321,870,672,8669,2156,2259,1389,4815,1399,4508,1348,307,402,152,300,155,282,563,526,1032,764
16055,127441,20573,62307,12742,17647,8620,35032,8045,33613,7850,1419,1896,428,1158,991,1505,1709,1967,7919,5030,65134,12277,13748,7262,36620,8447,34443,7982,2177,2580,823,1466,1354,2020,4647,3372,10119,5357
16057,33321,6566,17073,4391,8102,3425,7637,2238,7327,2208,310,560,74,440,236,491,328,577,1006,997,16248,4049,6326,3008,7511,2306,7158,2182,353,665,187,552,166,474,844,807,1567,1242
16059,6614,1288,3348,789,775,426,1817,569,1718,546,99,157,36,115,63,131,233,244,523,354,3266,737,556,328,1925,599,1851,589,74,136,9,100,65,130,406,308,379,290
16061,3116,287,1521,183,384,158,772,132,733,127,39,59,14,73,25,48,105,63,260,101,1595,202,310,136,850,148,785,143,65,64,23,49,42,59,205,83,230,100
16063,4056,641,2080,385,654,259,1180,262,1097,251,83,91,27,53,56,81,85,71,161,92,1976,376,463,201,1099,235,1061,238,38,57,8,37,30,50,188,125,226,118
16065,30052,7187,15086,4454,5398,3602,9184,2073,8928,2005,256,489,66,310,190,431,176,329,328,506,14966,4548,5406,3629,8564,1858,8347,1863,217,459,8,259,209,464,408,424,588,645
16067,15760,3740,7866,2186,2152,1208,4709,1536,4333,1410,376,521,29,213,347,514,230,353,775,688,7894,2079,1674,1078,4598,1446,4397,1418,201,359,80,262,121,308,652,504,970,727
16069,33143,7019,16269,4387,4978,2866,8996,2670,8472,2573,524,814,232,603,292,634,438,700,1857,1529,16874,3998,3784,2227,8825,2699,8232,2580,593,739,131,468,462,676,1770,1335,2495,1825
16071,3293,511,1642,290,288,159,1085,250,1015,248,70,66,15,43,55,62,64,54,205,129,1651,325,255,183,1099,247,1037,235,62,67,23,43,39,51,173,118,124,83
16073,9086,1537,4676,906,1323,583,2752,670,2539,651,213,212,57,126,156,191,125,163,476,320,4410,879,924,453,2616,657,2445,628,171,200,109,164,62,144,410,276,460,302
16075,18076,3993,8879,2319,2227,1395,5315,1610,5035,1564,280,441,86,242,194,374,181,349,1156,853,9197,2203,1852,1189,5184,1582,5037,1554,147,281,56,216,91,244,1000,738,1161,861
16077,5718,1379,2933,862,564,388,1902,652,1681,578,221,258,83,169,138,212,65,105,402,379,2785,812,670,407,1521,525,1465,514,56,111,36,92,20,92,263,225,331,298
16079,10485,2458,5206,1389,1285,758,2856,978,2623,927,233,308,99,249,134,241,198,261,867,561,5279,1384,877,620,3044,991,2809,941,235,299,104,230,131,249,510,418,848,625
16081,8983,1960,4698,1194,1592,814,2365,709,2199,679,166,231,37,96,129,180,72,124,669,532,4285,1089,1311,601,2346,744,2325,739,21,67,4,45,17,66,178,183,450,311
16083,65037,14767,31736,8578,8755,5415,18173,5472,17162,5198,1011,1413,422,1022,589,1105,849,1306,3959,3196,33301,8503,7259,4662,18914,5695,17312,5258,1602,2072,755,1367,847,1420,2881,2354,4247,3088
16085,9200,2701,4567,1526,1122,802,2675,1025,2504,960,171,306,78,181,93,239,124,160,646,670,4633,1457,904,695,2509,916,2390,909,119,173,58,136,61,141,692,498,528,538
16087,8097,1609,3972,944,1043,574,2161,619,2008,591,153,213,86,163,67,142,202,210,566,381,4125,986,705,489,2380,667,2179,645,201,222,89,167,112,171,471,339,569,399
17001,53488,11002,25868,6437,7550,4102,15002,4367,14237,4173,765,1202,227,815,538,1031,814,1191,2502,2005,27620,6491,6455,3922,14478,4237,13605,4006,873,1282,428,951,445,953,3274,2247,3413,2337
17003,4972,1276,2357,707,826,493,1119,435,985,370,134,177,79,150,55,140,121,128,291,251,2615,841,768,577,1081,425,881,345,200,198,103,131,97,152,410,296,356,263
17005,14021,3401,7230,2295,2579,1628,3721,1178,3532,1132,189,244,37,163,152,236,139,200,791,522,6791,1704,1522,929,3766,1207,3510,1115,256,323,165,272,91,190,772,543,731,555
17007,42767,9079,21217,5416,6842,3590,11943,3402,11134,3163,809,1103,254,598,555,875,548,780,1884,1515,21550,5149,5958,3234,11242,3132,10445,2946,797,1068,299,614,498,784,1829,1488,2521,1804
17009,5638,965,3642,694,1734,448,1397,399,1130,346,267,147,73,94,194,137,104,117,407,229,1996,439,336,201,1101,320,1049,303,52,85,26,77,26,74,247,161,312,207
17011,27391,4604,13389,2688,3732,1582,7786,1891,7365,1777,421,556,93,370,328,528,388,470,1483,930,14002,2687,3031,1486,7827,1903,7348,1818,479,536,216,419,263,440,1500,866,1644,945
17013,3997,755,1994,432,625,290,1073,274,981,246,92,120,73,117,19,61,84,87,212,137,2003,437,440,239,1121,258,1068,253,53,67,8,55,45,65,196,115,246,179
17015,12169,2235,6084,1353,1771,884,3423,868,3255,844,168,236,64,191,104,206,216,231,674,412,6085,1244,1284,746,3464,884,3352,871,112,173,37,173,75,164,766,473,571,393
17017,9966,1893,4926,1139,1534,756,2751,794,2581,763,170,237,26,167,144,218,107,187,534,396,5040,1067,1250,682,2511,737,2291,697,220,234,74,177,146,203,629,365,650,399
17019,176983,36088,87875,23465,43681,18567,35740,11196,32542,10244,3198,4173,764,2255,2434,3669,1952,2960,6502,5822,89108,23087,38319,17233,35312,10997,31804,9824,3508,4443,977,2323,2531,3860,6131,5093,9346,7162
17021,27372,5565,13841,3194,4284,2200,7087,2089,6464,2005,623,629,255,482,368,581,468,593,2002,1208,13531,3248,2786,1828,6992,2122,6608,2045,384,626,155,496,229,531,1734,1112,2019,1375
17023,12770,3158,6230,1816,1472,934,4007,1384,3829,1337,178,360,68,251,110,296,138,276,613,551,6540,1703,1069,745,3792,1277,3613,1245,179,294,109,262,70,224,823,637,856,619
17025,10846,1766,5364,1039,1406,658,3038,809,2996,807,42,117,10,103,32,111,182,212,738,481,5482,1036,1155,601,2889,775,2791,769,98,178,43,135,55,133,481,342,957,537
17027,31086,5410,16103,3193,5581,2204,8347,2128,7809,2032,538,531,133,393,405,477,457,505,1718,1203,14983,3203,3412,1872,8379,2087,8023,2089,356,518,164,435,192,413,1716,1088,1476,1203
17029,43611,11162,20968,6680,8569,4944,9153,3359,8731,3274,422,858,158,678,264,735,851,1148,2395,2018,22643,6750,7975,4523,9270,3379,8780,3292,490,894,267,747,223,700,2323,1839,3075,2291
17031,4243873,1034944,2036934,614777,895193,445110,940780,339288,843975,307674,96805,122518,35480,74937,61325,95476,53122,83728,147839,146668,2206939,616882,865324,426800,932621,331170,826248,299609,106373,125156,49043,84274,57330,90824,190426,158173,218568,176657
17033,15864,3151,8348,2048,2886,1135,4186,1279,3741,1122,445,462,144,274,301,360,271,323,1005,611,7516,1630,1230,803,4314,1235,4091,1198,223,328,177,310,46,190,847,564,1125,742
17035,8748,1606,4362,925,1139,591,2623,617,2514,609,109,139,35,124,74,131,141,155,459,329,4386,850,900,440,2603,633,2456,610,147,208,67,137,80,174,418,318,465,311
17037,85720,16783,42278,10781,20044,9041,18178,4928,17044,4646,1134,1490,526,1096,608,1088,816,1176,3240,2459,43442,9839,17242,7353,18558,5100,17221,4722,1337,1578,690,1125,647,1148,2775,2001,4867,3070
17039,13139,2372,6523,1458,1736,891,3794,958,3626,932,168,247,108,223,60,186,223,242,770,513,6616,1335,1215,641,3768,995,3580,933,188,301,40,177,148,284,741,512,892,517
17041,15579,2823,7650,1656,2223,1065,4340,1094,4072,1041,268,363,126,274,142,315,231,263,856,608,7929,1646,1720,926,4405,1082,4215,1064,190,272,127,246,63,201,782,529,1022,673
17043,754978,137147,367341,81082,120709,56825,213781,51173,203074,48686,10707,14427,2694,8779,8013,12674,8133,11956,24718,21554,387637,81175,106022,51763,213288,50312,200157,47856,13131,16007,4918,10541,8213,12703,30619,22767,37708,26548
17045,14535,3086,7070,1851,1923,1117,4238,1310,4132,1305,106,255,22,199,84,240,204,301,705,591,7465,1739,1455,896,3918,1218,3731,1194,187,314,134,275,53,239,1057,667,1035,731
17047,5251,792,2611,458,625,268,1507,331,1456,334,51,77,19,68,32,83,111,92,368,200,2640,450,429,229,1600,347,1527,341,73,95,38,76,35,84,294,169,317,192
17049,27376,4508,13503,2639,3973,1824,7756,1741,7386,1659,370,495,92,295,278,451,316,414,1458,1029,13873,2631,3209,1521,7699,1696,7406,1656,293,414,107,289,186,374,1497,919,1468,968
17051,17915,3460,9591,2054,3525,1408,4615,1248,4253,1165,362,370,131,310,231,303,224,295,1227,737,8324,1998,1856,1051,4479,1198,4306,1172,173,290,88,271,85,248,893,637,1096,764
17053,10872,1864,5287,1117,1468,681,3052,841,2869,818,183,267,47,166,136,253,168,185,599,413,5585,1107,1188,631,2972,797,2799,784,173,233,80,188,93,197,771,474,654,415
17055,31858,6295,15411,3751,4284,2285,8054,2335,7271,2196,783,908,341,583,442,768,717,817,2356,1621,16447,3775,3544,2067,7924,2281,7359,2204,565,749,289,593,276,578,2286,1469,2693,1687
17057,29436,6138,15464,3783,5439,2481,7365,2216,6748,2132,617,612,262,546,355,521,546,645,2114,1395,13972,3437,3101,1968,7169,2207,6884,2152,285,548,170,513,115,454,1933,1268,1769,1292
17059,4204,751,2048,451,482,244,1150,321,1080,319,70,89,19,64,51,91,142,119,274,176,2156,426,401,215,1047,294,998,295,49,82,31,79,18,52,342,180,366,201
17061,10908,2239,5461,1331,1619,772,2782,828,2639,796,143,250,61,193,82,244,235,270,825,526,5447,1311,1378,797,2782,857,2567,777,215,326,140,272,75,233,655,424,632,439
17063,40144,6584,19761,3887,5906,2728,11828,2695,11252,2698,576,743,294,598,282,511,398,537,1629,1328,20383,4003,4750,2338,11700,2754,11265,2703,435,649,184,492,251,523,1556,1210,2377,1542
17065,6693,1789,3335,1024,896,601,2037,726,1900,687,137,228,109,205,28,133,53,139,349,326,3358,970,535,444,1970,716,1889,688,81,155,29,119,52,144,449,340,404,326
17067,14879,2970,7332,1662,1876,956,4225,1132,4022,1085,203,302,125,285,78,227,369,319,862,667,7547,1745,1391,879,4265,1139,4054,1093,211,337,135,299,76,246,827,561,1064,690
17069,3426,845,1738,510,559,302,912,326,798,287,114,154,33,82,81,125,81,82,186,159,1688,524,312,265,954,369,731,266,223,244,40,79,183,229,242,205,180,141
17071,5785,1042,2828,598,633,280,1721,448,1683,438,38,94,32,100,6,77,170,166,304,208,2957,586,538,273,1719,435,1632,439,87,143,58,121,29,119,364,233,336,198
17073,40367,8688,19937,5135,5734,3292,11387,3267,10944,3158,443,838,169,688,274,717,706,960,2110,1794,20430,5080,4475,2798,11458,3274,11013,3171,445,873,190,681,255,736,2168,1621,2329,1851
17075,22901,3967,11162,2316,3089,1414,6367,1604,6127,1562,240,380,136,373,104,289,524,544,1182,738,11739,2271,2285,1131,6354,1562,6161,1546,193,305,104,302,89,279,1679,941,1421,822
17077,49249,11148,24313,6959,11943,5457,9584,3370,8746,3118,838,1108,432,850,406,858,571,912,2215,1995,24936,7050,10509,5240,9563,3389,8616,3068,947,1254,339,810,608,1002,1955,1704,2909,2194
17079,7742,1738,3816,1056,1047,621,2171,700,2044,661,127,194,71,186,56,153,84,179,514,446,3926,1030,908,578,2201,726,2103,699,98,170,62,172,36,133,412,325,405,367
17081,30970,5381,15959,3207,5450,2204,7945,1973,7109,1797,836,684,228,504,608,559,433,536,2131,1231,15011,3144,3451,1740,7869,1960,7378,1876,491,552,237,448,254,443,1532,954,2159,1270
17083,18278,3888,8815,2184,2633,1369,5052,1425,4819,1375,233,380,43,224,190,341,313,520,817,693,9463,2357,2233,1290,5103,1487,4794,1375,309,476,222,415,87,260,1032,837,1095,833
17085,18271,3553,9120,2109,2404,1297,5532,1519,5356,1507,176,271,73,266,103,251,255,353,929,688,9151,2054,1707,1007,5431,1487,5298,1468,133,299,47,284,86,270,1092,729,921,712
17087,10659,1685,6013,1051,2421,618,2776,676,2283,578,493,216,98,149,395,191,193,211,623,357,4646,883,779,460,2822,658,2725,663,97,155,58,136,39,129,539,302,506,280
17089,419079,86198,207131,52116,71323,35051,115134,30736,107087,28384,8047,9990,2901,5799,5146,7575,4762,6876,15912,13808,211948,48452,61004,31160,113969,29792,105766,27846,8203,9550,4094,6581,4109,6593,15084,12052,21891,15741
17091,89799,16631,43787,10216,16690,7524,21354,5763,19398,5377,1956,2241,692,1431,1264,1769,1657,1852,4086,3230,46012,10255,15526,7110,21148,5749,19619,5430,1529,1828,521,1181,1008,1567,4444,2988,4894,3333
17093,95961,15951,46753,9644,15747,7029,27009,6269,25376,5640,1633,1915,344,826,1289,1712,855,1307,3142,2539,49208,9157,13524,6051,28082,6158,26597,5921,1485,1671,750,1059,735,1257,2878,2633,4724,3282
17095,42188,9021,21218,5535,8156,3783,9382,3074,8543,2861,839,1023,391,813,448,789,881,1062,2799,1946,20970,5272,5761,3145,9643,3190,8878,2976,765,1063,334,818,431,882,2459,1659,3107,2106
17097,562653,97814,279602,59261,95292,41944,159141,35666,149636,33550,9505,10721,2295,6154,7210,9363,5547,7963,19622,15974,283051,57501,78534,38716,154768,34593,145578,32729,9190,11014,3787,7447,5403,8445,21005,14923,28744,18809
17099,90469,18089,45393,10748,15301,7306,23575,7193,22262,6941,1313,1885,538,1424,775,1544,1489,2059,5028,3782,45076,10823,11038,6364,23684,7118,21978,6817,1706,2253,758,1604,948,1757,4956,3475,5398,3975
17101,13612,2594,7467,1521,2697,853,3651,1205,3188,1108,463,353,106,225,357,335,238,325,881,620,6145,1542,1062,743,3321,1104,3206,1093,115,214,51,189,64,196,870,652,892,670
17103,28794,5811,15478,3468,5388,2177,7622,2354,6769,2222,853,744,214,508,639,643,516,624,1952,1280,13316,3328,3124,1901,7015,2237,6715,2178,300,575,92,464,208,507,1551,1184,1626,1258
17105,29746,5170,15144,3155,5317,1995,7552,2031,6878,1904,674,658,228,509,446,519,518,590,1757,1089,14602,3057,3307,1759,7563,2078,7138,1999,425,571,174,449,251,478,1985,1240,1747,1120
17107,24443,4169,11965,2690,4079,1735,6071,1653,5616,1576,455,458,162,348,293,398,356,460,1459,923,12478,2577,3527,1512,6155,1624,5644,1579,511,436,147,307,364,405,1246,825,1550,942
17109,26068,6365,12537,3770,5679,2977,5171,1824,4913,1760,258,517,87,393,171,451,405,585,1282,1138,13531,3961,5409,2856,5050,1896,4707,1751,343,596,158,461,185,505,1478,967,1594,1212
17111,248756,42670,123096,25523,38217,17358,72105,16098,69250,15510,2855,4061,959,2618,1896,3331,3038,3953,9736,7655,125660,24472,31034,15513,72138,16189,68758,15588,3380,4406,1570,3057,1810,3257,9308,6618,13180,8640
17113,141515,25013,68258,15736,27536,12421,33652,7810,32080,7534,1572,2103,512,1490,1060,1802,1738,2298,5332,3922,73257,15870,26833,11845,34612,8169,32773,7635,1839,2462,864,1776,975,1902,4769,3797,7043,4579
17115,86016,18140,40543,10646,13877,7519,20109,6069,18589,5620,1520,2161,598,1444,922,1752,1263,1799,5294,3833,45473,11202,13496,7352,20903,6278,19277,5912,1626,1972,660,1391,966,1678,4945,3633,6129,4167
17117,37548,8125,18342,4745,5218,2911,10320,3134,9971,3063,349,727,132,572,217,677,705,900,2099,1602,19206,4712,4355,2578,10345,3162,9765,3007,580,887,223,659,357,752,1889,1414,2617,1839
17119,216594,45440,104218,27182,33174,18048,56037,16836,52785,15900,3252,4770,1682,3566,1570,3381,3402,4404,11605,9338,112376,27093,29596,16919,55925,16543,52528,15675,3397,4787,1834,3621,1563,3444,11479,8378,15376,10750
17121,30493,5892,14802,3483,4494,2155,7845,2264,7391,2161,454,658,250,572,204,505,562,669,1901,1263,15691,3336,3728,1863,7826,2248,7366,2122,460,687,330,624,130,467,1932,1215,2205,1357
17123,9734,1312,4777,758,1378,487,2723,535,2575,517,148,155,52,124,96,154,201,168,475,308,4957,809,951,436,2785,553,2624,537,161,192,63,133,98,168,669,308,552,302
17125,11329,2196,5547,1283,1535,826,3062,882,2928,833,134,238,69,230,65,213,297,301,653,479,5782,1284,1231,696,3125,903,3018,886,107,227,65,208,42,216,759,485,667,500
17127,11531,2374,5466,1355,1389,765,3271,985,3102,964,169,256,40,161,129,240,166,220,640,485,6065,1398,1183,740,3409,1002,3130,980,279,320,114,233,165,250,828,548,645,487
17129,10077,1874,4914,1048,1186,595,3163,782,3065,773,98,139,43,132,55,114,145,197,420,307,5163,1060,939,506,3084,753,2989,738,95,164,37,127,58,170,570,355,570,334
17131,12882,2367,6399,1367,1574,780,3794,951,3638,925,156,251,54,213,102,218,232,244,799,528,6483,1379,1332,736,3927,978,3752,957,175,274,102,223,73,214,674,452,550,421
17133,27942,3333,13633,2088,3524,1486,8616,1382,8490,1370,126,249,35,180,91,226,264,319,1229,845,14309,2083,3003,1448,8829,1439,8500,1413,329,383,174,277,155,266,1174,705,1303,775
17135,24051,5387,12715,3465,4232,2209,6285,1849,5626,1734,659,531,169,370,490,452,412,444,1786,1059,11336,2685,2086,1402,6061,1819,5898,1787,163,317,63,286,100,289,1385,938,1804,1132
17137,28815,5877,14475,3663,5305,2359,6974,2259,6378,2158,596,649,252,553,344,471,391,569,1805,1297,14340,3463,3856,2032,6537,2141,6159,2037,378,552,145,439,233,501,1680,1119,2267,1487
17139,11630,2013,5663,1154,1302,687,3636,849,3430,821,206,259,72,198,134,221,205,224,520,416,5967,1174,1003,590,3490,828,3366,802,124,201,53,156,71,193,753,491,721,473
17141,41678,7654,20514,4605,5812,2933,11911,3146,11441,3047,470,799,229,650,241,596,635,810,2156,1735,21164,4553,4745,2714,11522,3080,11089,2996,433,727,130,523,303,655,2259,1510,2638,1839
17143,146257,29799,69859,17455,26982,12956,33371,9965,31345,9392,2026,2991,646,1940,1380,2587,2101,2801,7405,5563,76398,18708,24594,12322,33740,10265,31505,9605,2235,3195,1073,2407,1162,2369,7094,5688,10970,7474
17145,17921,3347,9987,2114,3897,1283,4738,1485,4296,1417,442,365,84,255,358,341,324,428,1028,713,7934,1868,1459,962,4292,1421,3960,1338,332,491,237,433,95,288,918,696,1265,872
17147,13366,2521,6553,1556,1718,988,3980,1012,3855,994,125,239,54,215,71,198,195,237,660,480,6813,1425,1240,741,4194,1011,4023,1006,171,244,49,167,122,233,666,510,713,512
17149,12711,2622,6251,1512,1769,832,3484,957,3313,940,171,245,60,210,111,220,202,301,796,533,6460,1542,1448,855,3418,942,3228,906,190,246,74,205,116,217,831,542,763,495
17151,3641,773,1941,485,557,314,921,266,860,258,61,67,51,64,10,39,119,98,344,240,1700,442,319,250,845,263,786,248,59,64,29,43,30,58,261,178,275,209
17153,4518,1018,2223,594,691,351,1179,378,1035,353,144,150,51,89,93,120,94,111,259,201,2295,615,676,401,1086,346,897,314,189,143,54,104,135,146,269,163,264,173
17155,4826,757,2451,424,585,240,1508,342,1423,332,85,94,31,80,54,81,101,111,257,160,2375,465,481,222,1426,329,1328,306,98,140,37,89,61,123,184,117,284,167
17157,27215,5420,15154,3352,6259,2339,6763,1983,5940,1831,823,655,179,429,644,533,459,564,1673,1058,12061,2976,2510,1758,6455,1892,6084,1838,371,528,182,431,189,401,1497,1022,1599,1138
17159,12718,2296,6270,1379,1920,885,3195,871,3025,853,170,255,107,220,63,193,206,247,949,574,6448,1375,1167,712,3426,938,3258,906,168,245,74,178,94,211,745,468,1110,642
17161,117025,22798,57179,13943,19656,9131,28974,8779,26993,8356,1981,2589,900,1915,1081,1980,2054,2541,6495,4904,59846,13536,16134,8393,28727,8594,26713,8180,2014,2502,761,1744,1253,2065,6587,4401,8398,5531
17163,211049,51114,100335,30224,36944,21330,49900,16756,45643,15234,4257,5674,1814,3690,2443,4349,2981,4498,10510,9302,110714,30537,35737,20582,50283,16486,45646,15190,4637,5785,2393,4225,2244,3970,10256,8476,14438,10831
17165,19736,4762,9594,2811,2725,1647,5236,1857,4879,1708,357,589,159,459,198,464,230,396,1403,1043,10142,2639,1878,1262,5264,1806,4926,1727,338,520,264,494,74,326,1388,951,1612,1182
17167,160530,33398,75933,20008,26943,14149,37935,11707,35826,11164,2109,3429,828,2467,1281,2871,2118,3204,8937,7204,84597,20683,25746,13724,39029,12185,36214,11267,2815,4050,1348,2952,1467,3043,7506,6072,12316,8268
17169,5903,1358,3125,902,1200,628,1318,526,1185,455,133,183,34,112,99,167,189,204,418,273,2778,702,563,352,1435,474,1352,457,83,118,59,113,24,82,366,238,414,278
17171,4117,504,1998,289,497,175,1191,203,1162,197,29,42,8,26,21,46,73,51,237,101,2119,300,453,158,1160,205,1111,205,49,70,18,45,31,61,264,122,242,117
17173,17991,3779,8768,2249,2158,1393,5509,1579,5275,1525,234,392,82,303,152,336,182,288,919,710,9223,2127,1782,1205,5248,1493,5059,1444,189,360,74,275,115,312,1061,730,1132,766
17175,4516,814,2236,454,619,265,1277,319,1190,310,87,99,26,83,61,95,109,106,231,149,2280,474,454,207,1236,318,1211,321,25,62,0,88,25,62,332,187,258,165
17177,37068,7676,17800,4583,5263,2885,10057,2948,9382,2780,675,906,348,761,327,666,560,780,1920,1624,19268,4706,4520,2691,10002,2984,9215,2751,787,998,418,773,369,759,2219,1620,2527,1865
17179,107985,18037,52767,11058,15201,7552,30670,7117,29270,6857,1400,1767,414,1224,986,1485,1567,1771,5329,3893,55218,10707,11970,6315,30050,6916,28864,6734,1186,1688,588,1316,598,1269,6098,3978,7100,4396
17181,13985,2780,6964,1683,2186,1113,3767,1112,3482,1027,285,377,50,162,235,348,216,261,795,526,7021,1571,1632,937,3683,1069,3473,1043,210,271,130,226,80,196,876,580,830,600
17183,62249,12125,30730,7199,10817,4804,14746,4453,13581,4178,1165,1379,528,1096,637,989,1056,1269,4111,2772,31519,7283,8273,4314,14970,4545,13851,4263,1119,1465,622,1095,497,1034,3606,2359,4670,2942
17185,9373,2050,4548,1155,1067,676,2840,885,2699,865,141,202,33,153,108,197,156,203,485,393,4825,1190,766,444,2847,876,2652,832,195,265,99,212,96,209,585,428,627,468
17187,14087,3064,6743,1843,2262,1196,3595,1207,3425,1193,170,307,53,237,117,282,155,316,731,584,7344,1831,2117,1152,3528,1226,3214,1106,314,434,82,280,232,381,762,577,937,668
17189,11568,2041,5765,1179,1487,745,3474,847,3363,825,111,193,75,201,36,168,112,170,692,445,5803,1194,1021,610,3497,856,3310,818,187,250,120,207,67,206,632,419,653,436
17191,13309,2379,6574,1428,1446,742,3924,1032,3723,978,201,282,67,195,134,266,296,349,908,567,6735,1357,1210,730,3810,989,3644,968,166,245,56,212,110,203,911,516,804,513
17193,11404,2248,5534,1324,1246,659,3362,976,3106,875,256,374,137,280,119,248,188,249,738,530,5870,1372,923,671,3330,938,3173,900,157,243,69,189,88,211,752,479,865,515
17195,45780,10255,22516,6143,6708,4023,12364,3944,11761,3848,603,1040,234,794,369,890,903,1140,2541,2158,23264,5863,5234,3241,12404,3889,11685,3804,719,1135,249,830,470,965,2630,1965,2996,2252
17197,548596,94453,270361,56385,93689,39840,150405,33660,141827,31622,8578,10497,2357,6222,6221,9022,5402,7786,20865,16397,278235,55683,81475,37039,148676,32616,139802,31063,8874,10602,3870,7134,5004,8216,19998,14790,28086,18464
17199,54783,12214,27110,7315,8670,4751,13538,4311,12602,4105,936,1187,369,856,567,971,1125,1350,3777,2865,27673,7070,6450,3947,13906,4540,12825,4177,1081,1490,587,1112,494,1051,3344,2325,3973,2720
17201,229558,52824,110760,30941,38527,21013,56643,18744,52790,17660,3853,5733,1483,4093,2370,4621,3237,4906,12353,10115,118798,31257,34903,19973,56490,18574,52013,17458,4477,6182,2225,4542,2252,4539,11766,9500,15639,11396
17203,30985,4982,15292,3026,4323,2008,9261,2064,8966,2013,295,461,77,308,218,435,582,639,1126,937,15693,2962,3485,1812,9171,2056,8736,1989,435,615,111,354,324,546,1639,1024,1398,1026
18001,25953,5821,12737,3520,3861,2300,7372,2213,7037,2109,335,619,104,400,231,567,444,686,1060,978,13216,3339,2903,1846,7397,2186,6840,2033,557,783,270,584,287,547,1446,1112,1470,1073
18003,292590,58827,141157,34956,49635,24984,72424,20760,68643,19885,3781,5841,1582,4366,2199,4705,3638,5419,15460,11516,151433,35545,45039,23625,74008,21180,69285,20185,4723,6547,2083,4672,2640,5088,12737,9808,19649,13440
18005,65985,14045,32773,8506,10391,5765,17736,5346,16239,4865,1497,1895,341,1010,1156,1602,990,1393,3656,2999,33212,8285,8090,4908,17261,5241,16259,4919,1002,1470,313,963,689,1263,3018,2535,4843,3488
18007,6909,1233,3376,734,948,435,1810,476,1730,470,80,135,11,123,69,137,100,129,518,323,3533,702,806,371,1895,502,1774,479,121,148,81,144,40,112,365,203,467,291
18009,9876,1836,4877,1091,1321,703,2854,754,2759,749,95,162,31,142,64,140,184,215,518,357,4999,1015,916,560,2816,746,2707,726,109,194,83,185,26,144,526,388,741,416
18011,51145,8046,24904,4915,5999,2986,16370,3427,15827,3391,543,751,126,517,417,667,543,776,1992,1679,26241,4574,5313,2829,16500,3422,15682,3347,818,1077,369,758,449,786,1756,1329,2672,1833
18013,12929,2459,6312,1442,1433,812,3934,993,3779,978,155,246,77,203,78,187,235,279,710,543,6617,1432,1110,848,4111,1035,3817,993,294,345,59,194,235,308,768,533,628,460
18015,16483,3529,8229,2029,2227,1193,4655,1265,4500,1224,155,310,15,213,140,310,224,298,1123,793,8254,1960,1701,1111,4641,1284,4391,1231,250,357,104,291,146,294,885,641,1027,731
18017,30709,7084,15316,4338,5110,2880,7801,2539,7342,2417,459,782,104,509,355,707,562,769,1843,1411,15393,3911,3537,2075,8026,2671,7399,2514,627,931,246,651,381,726,1792,1411,2038,1468
18019,94474,18854,45618,11393,14363,7380,23692,6953,21640,6261,2052,2698,1151,1900,901,1715,1557,1966,6006,4312,48856,11698,12786,7283,23983,6721,21976,6284,2007,2450,1031,1691,976,1717,4423,3270,7664,4848
18021,21289,5173,10463,3057,2543,1630,6207,2090,5957,2029,250,477,165,420,85,367,434,571,1279,1047,10826,2907,1988,1307,6316,2110,6136,2083,180,450,120,420,60,343,1101,858,1421,1099
18023,25248,5907,12474,3353,3750,2001,6792,2301,6319,2172,473,663,138,451,335,582,418,670,1514,1119,12774,3380,2954,1847,7053,2287,6528,2220,525,700,306,550,219,509,1300,1081,1467,1072
18025,8589,1741,4387,978,1304,577,2325,631,2224,620,101,158,38,116,63,131,155,147,603,392,4202,1077,884,527,2204,695,1982,571,222,294,111,194,111,178,656,473,458,282
18027,25005,6048,12439,3591,3528,2238,6960,2062,6504,1925,456,698,104,394,352,633,397,510,1554,1181,12566,3384,3058,1929,7163,2088,6819,1995,344,578,146,448,198,455,1143,890,1202,993
18029,40363,8046,19931,4723,5510,2980,11549,3101,10978,2971,571,840,252,600,319,674,655,870,2217,1691,20432,4869,4731,2779,11477,3036,10874,2923,603,820,268,592,335,634,2014,1582,2210,1625
18031,21347,4526,10521,2599,2852,1592,5769,1659,5517,1583,252,409,62,260,190,390,275,435,1625,1075,10826,2620,2485,1451,5959,1700,5703,1645,256,387,65,276,191,332,930,740,1452,1060
18033,34235,7010,16926,4254,4835,2758,9328,2665,9056,2612,272,587,137,499,135,490,518,742,2245,1588,17309,3985,4146,2418,9318,2674,9035,2645,283,557,130,466,153,474,1604,1284,2241,1528
18035,97651,22535,46618,13873,19527,10038,20003,7118,18975,6793,1028,1953,499,1598,529,1519,1375,2038,5713,4529,51033,13808,18188,9407,20902,7394,19309,6921,1593,2360,777,1806,816,1800,4869,3837,7074,4820
18037,33792,6928,16635,4063,4703,2760,9897,2726,9552,2671,345,563,44,374,301,530,514,738,1521,1370,17157,4122,4140,2733,9115,2531,8912,2491,203,479,67,389,136,424,1743,1340,2159,1618
18039,157333,33404,77184,19838,25418,13399,41565,11780,38656,10991,2909,3656,1035,2441,1874,2940,1920,2779,8281,6581,80149,19516,21588,11874,41801,11882,38489,11035,3312,4163,1713,2952,1599,2787,6915,5444,9845,7087
18041,19065,4127,9298,2445,2547,1504,4917,1613,4515,1515,402,563,106,378,296,506,261,431,1573,1091,9767,2503,1941,1358,5065,1615,4663,1536,402,562,143,403,259,466,997,821,1764,1194
18043,62878,12201,30068,7294,9980,5052,15929,4206,14903,3968,1026,1397,381,969,645,1138,751,1116,3408,2535,32810,7455,8615,4528,15991,4294,14711,3919,1280,1615,670,1225,610,1188,3135,2251,5069,3186
18045,13482,2522,6640,1444,1767,902,3838,1072,3639,1051,199,283,100,234,99,236,261,305,774,537,6842,1463,1158,720,3930,1102,3810,1086,120,214,49,208,71,202,793,494,961,620
18047,18325,3367,9110,2006,2486,1211,5302,1356,5232,1355,70,212,42,217,28,187,336,391,986,766,9215,1980,2046,1184,5658,1450,5457,1408,201,319,65,212,136,272,756,582,755,584
18049,16166,4234,7918,2482,2116,1465,4230,1440,4041,1393,189,385,125,341,64,294,287,415,1285,993,8248,2464,1736,1418,4315,1472,4139,1430,176,342,80,293,96,306,957,770,1240,924
18051,27112,5116,13480,2975,3871,1877,7597,2019,7128,1956,469,611,166,451,303,508,310,436,1702,1129,13632,2909,2803,1566,7883,2098,7614,2045,269,402,70,329,199,396,1195,899,1751,1158
18053,55037,11232,25974,6629,8765,4284,12821,4161,12059,4015,762,1059,264,781,498,896,813,1080,3575,2428,29063,6743,8722,4093,13108,4169,12156,4000,952,1190,446,940,506,894,3185,2182,4048,2644
18055,26451,5984,13139,3355,3224,1860,7511,2305,7195,2185,316,582,119,455,197,503,468,658,1936,1384,13312,3431,2264,1614,7571,2312,7167,2193,404,647,194,505,210,519,1504,1141,1973,1341
18057,250199,33470,120585,20756,32340,14305,76872,13601,74679,13283,2193,3060,785,2058,1408,2430,1792,2637,9581,6938,129614,20180,30417,13486,77768,13770,74616,13294,3152,3819,1662,2809,1490,2533,7702,5478,13727,7650
18059,60828,11334,29607,6718,7699,4279,18134,4688,17228,4457,906,1127,312,768,594,845,953,1170,2821,2291,31221,6580,7126,4092,17654,4364,16601,4279,1053,1208,245,676,808,1044,2708,2169,3733,2614
18061,32523,6334,16132,3821,4733,2445,8555,2387,8194,2241,361,597,259,548,102,325,789,872,2055,1505,16391,3896,3721,2205,8934,2457,8417,2332,517,741,264,525,253,477,1589,1170,2147,1574
18063,129913,22159,64411,13491,18707,9238,37346,8550,35208,8169,2138,2470,840,1610,1298,1856,1837,2320,6521,4467,65502,13272,14625,7531,37082,8567,35442,8200,1640,2182,761,1487,879,1534,5352,3970,8443,5203
18065,40227,8072,21162,4999,6930,3356,10246,2987,9340,2820,906,897,382,721,524,725,598,770,3388,1816,19065,4536,4110,2482,9762,2902,9091,2733,671,956,307,697,364,752,2067,1423,3126,1984
18067,66930,14565,31953,8784,9413,5480,17588,5552,16401,5298,1187,1601,452,1115,735,1291,888,1384,4064,3037,34977,8601,7825,4657,17552,5624,16365,5325,1187,1796,585,1268,602,1343,3707,2756,5893,3768
18069,29885,5552,14663,3296,4176,2144,8394,2195,7961,2083,433,650,84,429,349,606,321,485,1772,1274,15222,3311,3515,1824,8380,2178,7956,2082,424,640,221,495,203,496,1365,1040,1962,1304
18071,35111,7335,17230,4334,4942,2614,9374,2781,8988,2698,386,639,201,560,185,516,591,796,2323,1663,17881,4377,3673,2294,9448,2713,8848,2579,600,858,278,605,322,685,2061,1440,2699,1831
18073,27117,5429,13450,3268,4214,2128,7346,1970,7063,1961,283,451,132,383,151,355,301,430,1589,1202,13667,3215,3600,1994,7282,2015,7044,1977,238,450,120,382,118,352,1331,1068,1454,1073
18075,16497,3669,8127,2180,2565,1456,4109,1287,3965,1257,144,324,59,270,85,304,294,381,1159,852,8370,2049,1923,1094,4343,1329,4008,1267,335,475,181,375,154,358,908,616,1196,836
18077,26766,5579,12565,3286,3693,1893,6656,2162,6347,2088,309,528,126,383,183,426,428,578,1788,1291,14201,3307,3785,1881,6630,2046,5840,1915,790,658,261,425,529,562,1359,1035,2427,1403
18079,22469,4817,11283,2960,3138,1768,6124,1841,5792,1805,332,453,224,384,108,278,555,555,1466,1111,11186,2694,2361,1446,5960,1796,5681,1779,279,434,114,296,165,329,1091,866,1774,1151
18081,122114,23154,59279,13257,16991,9001,34138,8405,32786,8236,1352,2050,390,1250,962,1748,1494,2027,6656,4978,62835,13818,15340,8355,33940,8518,32374,8222,1566,2384,393,1246,1173,2064,5307,3929,8248,5513
18083,30551,7982,15397,4740,5394,3014,7557,2997,7095,2858,462,833,164,618,298,707,510,815,1936,1643,15154,4520,3390,2333,7604,3023,7222,2918,382,784,173,632,209,662,1692,1427,2468,1908
18085,63237,12408,31365,7299,8750,4899,18417,4893,17663,4762,754,1251,158,784,596,1140,664,1047,3534,2663,31872,7058,7536,4142,17536,4637,16675,4511,861,1249,342,903,519,1016,2738,2013,4062,2726
18087,28518,5394,14309,3205,4462,2034,8380,2005,8169,1958,211,418,63,317,148,387,348,423,1119,939,14209,3054,3234,1623,8812,2110,8399,2008,413,601,287,538,126,356,1073,884,1090,899
18089,391621,88068,186928,51740,71610,36870,89816,28844,83631,27039,6185,9013,2464,6278,3721,7213,6286,8678,19216,16089,204693,52484,67439,35223,90907,29151,84251,27356,6656,9171,3592,7021,3064,6614,21069,15344,25278,18229
18091,90535,17595,46790,10640,17254,7260,21178,6475,19058,6084,2120,1863,474,1242,1646,1652,1672,2013,6686,4001,43745,10189,10991,5974,21406,6639,20270,6446,1136,1719,432,1251,704,1433,4216,3130,7132,4559
18093,37374,8997,18232,5151,4570,2909,10654,3572,9974,3464,680,969,328,765,352,692,638,911,2370,1957,19142,5183,3484,2534,10423,3550,10001,3482,422,809,292,732,130,551,2091,1655,3144,2246
18095,106269,21320,52648,12957,17207,8593,25987,7802,24359,7500,1628,2078,632,1620,996,1772,1664,2239,7790,5217,53621,12572,13302,7495,25367,7664,23704,7252,1663,2400,982,1966,681,1660,5860,4067,9092,5500
18097,752995,172158,356724,105985,160237,80837,150153,54820,133551,48983,16602,21572,5763,12476,10839,17309,8711,13683,37623,30792,396271,106169,158604,77127,151405,53990,134116,48914,17289,21019,7552,13520,9737,15919,30597,25690,55665,37564
18099,36886,7701,18108,4478,5174,2626,10323,2965,9874,2857,449,755,131,520,318,657,448,672,2163,1512,18778,4345,4535,2407,10052,2853,9463,2729,589,885,166,542,423,777,1826,1313,2365,1512
18101,8356,1760,4196,1034,1251,695,2051,709,1915,667,136,212,76,162,60,152,108,183,786,534,4160,1115,1008,643,2009,686,1970,681,39,137,16,122,23,130,482,354,661,392
18103,29530,6398,15815,3810,5111,2436,8236,2450,7333,2355,903,821,390,655,513,610,449,596,2019,1342,13715,3680,2828,1947,7503,2339,7103,2246,400,633,212,524,188,507,1267,1039,2117,1428
18105,127432,26246,63050,16814,32258,13490,24562,7629,22988,7222,1574,2420,435,1537,1139,2037,989,1852,5241,4606,64382,16996,27361,12627,24623,7722,22476,7171,2147,2862,822,1843,1325,2254,4301,3641,8097,5493
18107,31116,6253,15727,3717,4643,2321,8721,2430,8233,2290,488,686,321,636,167,473,532,671,1831,1294,15389,3530,3026,1818,8818,2477,8319,2335,499,724,362,636,137,452,1307,1040,2238,1449
18109,56969,11219,27994,6536,7668,4052,15716,4173,15087,4090,629,957,190,632,439,868,928,1173,3682,2646,28975,6601,6281,3644,16090,4256,15030,4086,1060,1384,552,999,508,932,2629,1876,3975,2663
18111,11523,2387,5816,1423,1694,876,3185,964,2932,927,253,299,105,217,148,260,236,254,701,460,5707,1350,1053,698,3144,998,2939,937,205,265,134,230,71,173,745,483,765,479
18113,37608,7086,18752,4150,5298,2726,10418,2753,9817,2663,601,804,320,657,281,581,517,735,2519,1669,18856,4073,4064,2323,10378,2795,10043,2721,335,667,201,579,134,490,1760,1164,2654,1721
18115,4945,924,2482,523,562,247,1595,404,1539,400,56,97,21,77,35,80,100,127,225,184,2463,540,442,322,1492,387,1478,386,14,68,10,73,4,67,284,213,245,164
18117,15887,3371,7888,1922,2235,1144,4169,1219,3859,1188,310,400,81,282,229,351,193,306,1291,848,7999,1991,1529,902,4044,1183,3842,1176,202,327,90,252,112,298,1003,668,1423,924
18119,17265,3065,8816,1817,2274,1077,4739,1323,4498,1273,241,340,110,265,131,275,263,384,1540,856,8449,1802,1649,894,4746,1367,4558,1317,188,313,122,265,66,224,781,577,1273,877
18121,13921,3438,6605,1999,1442,1021,3908,1296,3784,1273,124,285,57,236,67,260,150,304,1105,900,7316,1953,1561,932,4058,1271,3544,1223,514,385,155,302,359,313,597,530,1100,764
18123,15686,2864,8431,1680,2554,1074,4456,1258,4041,1210,415,318,87,220,328,274,207,274,1214,708,7255,1599,1339,794,4072,1161,3944,1155,128,243,79,229,49,197,904,581,940,611
18125,10078,1970,5033,1162,1314,665,2745,766,2633,753,112,196,37,143,75,187,190,253,784,542,5045,1157,952,553,2896,819,2759,791,137,229,51,179,86,202,534,444,663,464
18127,138325,22845,67827,14264,22965,10221,36354,8696,34573,8376,1781,2362,696,1568,1085,1914,2031,2283,6477,4754,70498,13752,18486,8694,36560,8711,34636,8347,1924,2454,891,1764,1033,1776,6232,4277,9220,5810
18129,20961,4208,10405,2564,2583,1473,6475,1766,6145,1672,330,503,57,325,273,477,283,497,1064,824,10556,2351,1997,1252,6191,1702,5964,1632,227,424,34,302,193,401,1040,822,1328,962
18131,10217,2164,5137,1283,1324,817,2909,852,2714,826,195,236,46,156,149,225,144,190,760,531,5080,1182,969,561,2616,803,2523,783,93,195,32,159,61,186,701,515,794,465
18133,31408,6057,16645,3598,6110,2496,8168,2300,7315,2190,853,636,278,439,575,515,452,550,1915,1245,14763,3400,4072,1973,7532,2142,7305,2137,227,417,78,341,149,386,1232,1056,1927,1370
18135,20268,4423,9908,2586,3051,1707,5205,1625,4993,1610,212,390,92,361,120,360,319,439,1333,985,10360,2586,2263,1389,5202,1678,4859,1587,343,515,190,410,153,433,1345,906,1550,1026
18137,22922,4096,11218,2365,3222,1531,6421,1622,6047,1553,374,483,170,381,204,363,361,451,1214,799,11704,2526,2342,1398,6490,1656,6162,1607,328,444,129,314,199,358,1247,813,1625,1056
18139,13641,3078,6607,1777,1725,987,3623,1164,3495,1148,128,265,45,236,83,236,225,320,1034,736,7034,1763,1316,872,3853,1201,3649,1176,204,338,101,275,103,266,668,528,1197,759
18141,217289,46206,104427,27747,40008,19870,50905,15791,47472,14677,3433,5066,1322,3633,2111,4223,2755,4495,10759,8764,112862,27872,36714,18630,52042,15873,48292,14821,3750,5470,1881,3993,1869,4200,10154,7814,13952,9780
18143,19361,4861,9547,2758,2962,1774,5067,1720,4707,1705,360,470,191,384,169,342,363,471,1155,999,9814,2846,2110,1503,5413,1856,5133,1777,280,471,121,322,159,365,892,827,1399,1143
18145,36070,7127,17630,4188,4460,2485,9893,2855,9346,2750,547,808,222,591,325,626,745,879,2532,1797,18440,4113,4158,2412,10042,2844,9516,2773,526,791,337,647,189,551,2101,1435,2139,1444
18147,16747,2647,8404,1573,2004,903,5104,1147,4902,1141,202,234,97,218,105,206,328,378,968,585,8343,1544,1598,789,4919,1139,4754,1100,165,233,52,171,113,222,940,595,886,547
18149,18566,4038,9153,2338,2791,1500,4691,1353,4454,1304,237,382,145,357,92,290,364,446,1307,934,9413,2325,2174,1329,4833,1430,4535,1356,298,442,84,274,214,419,899,716,1507,973
18151,28698,6017,14524,3537,4306,2197,8036,2263,7719,2213,317,533,176,456,141,424,447,572,1735,1177,14174,3433,2942,1785,8237,2420,7861,2348,376,598,191,503,185,446,1341,1002,1654,1143
18153,17380,3754,9365,2203,3089,1248,4218,1362,3795,1306,423,353,85,279,338,289,229,347,1829,994,8015,2179,1619,1120,4355,1456,4131,1411,224,364,187,357,37,241,1043,749,998,785
18155,8512,1662,4347,982,1272,537,2424,719,2295,699,129,179,97,157,32,98,159,194,492,313,4165,894,747,429,2399,676,2330,684,69,116,13,94,56,105,393,281,626,378
18157,158503,29814,81046,20075,40891,16179,32310,9475,29258,8279,3052,3647,816,1888,2236,3049,1794,2481,6051,5016,77457,17643,31397,13368,31618,8800,29291,8170,2327,2888,944,1943,1383,2293,5067,4139,9375,6194
18159,12652,2907,6274,1677,1601,1008,3785,1244,3651,1194,134,255,7,192,127,267,189,314,699,604,6378,1657,1180,838,3824,1281,3671,1243,153,278,61,223,92,242,674,534,700,622
18161,5870,1170,2863,647,800,366,1626,450,1543,439,83,124,19,92,64,113,61,94,376,270,3007,708,560,306,1672,469,1495,454,177,188,54,95,123,175,328,220,447,261
18163,148324,34215,70991,20753,25085,13929,34214,12089,32252,11575,1962,3393,581,2314,1381,2983,2150,3321,9542,7749,77333,20233,22735,12357,34580,12144,32126,11470,2454,3745,938,2681,1516,3008,7323,5978,12695,8853
18165,12768,2796,6311,1639,1653,981,3541,1176,3370,1127,171,299,57,243,114,261,226,338,891,619,6457,1584,1231,792,3350,1093,3197,1064,153,307,75,246,78,275,694,575,1182,734
18167,89163,19716,45035,12919,18545,9266,19243,6688,17529,6311,1714,2106,661,1581,1053,1676,1092,1773,6155,4383,44128,11481,14111,7382,18660,6482,17578,6202,1082,1857,442,1353,640,1604,4419,3555,6938,4703
18169,26171,5545,12716,3203,3511,1931,7269,2230,7010,2172,259,570,127,496,132,467,408,624,1528,1215,13455,3404,3215,2010,7006,2132,6664,2068,342,610,184,539,158,451,1415,1112,1819,1330
18171,6744,1153,3365,674,736,363,2152,502,2051,485,101,129,57,114,44,109,145,180,332,224,3379,665,530,289,2157,538,2043,518,114,159,60,104,54,137,331,231,361,254
18173,50175,10101,24579,5622,5707,3199,15718,4153,15065,4034,653,951,194,663,459,839,587,962,2567,2135,25596,5925,4900,3214,15505,4028,14957,3938,548,931,265,716,283,709,2080,1743,3111,2220
18175,22657,4841,11291,2892,2873,1664,6640,1872,6355,1784,285,486,41,262,244,461,356,450,1422,1025,11366,2665,2307,1513,6417,1776,6049,1727,368,504,126,312,242,457,1143,762,1499,965
18177,54263,10472,26123,6269,8306,4108,12921,3819,12173,3650,748,1094,193,715,555,954,946,1117,3950,2546,28140,6096,6796,3698,13112,3838,12143,3620,969,1283,579,1029,390,836,3557,2217,4675,2716
18179,22326,4485,10791,2653,2860,1667,6756,1823,6506,1771,250,437,94,348,156,378,318,455,857,801,11535,2583,2217,1328,6789,1848,6353,1725,436,582,200,460,236,422,1189,770,1340,1024
18181,19452,3986,9671,2407,2429,1434,5700,1627,5429,1586,271,424,98,348,173,363,326,456,1216,943,9781,2284,1957,1207,5487,1613,5256,1550,231,389,34,274,197,388,1095,825,1242,885
18183,27287,5289,13453,3106,3425,1903,8192,2251,7880,2149,312,539,162,435,150,412,414,568,1422,1080,13834,3139,2628,1679,8159,2221,7837,2139,322,548,177,437,145,432,1414,1081,1633,1110
19001,5831,879,2858,543,705,310,1732,387,1671,387,61,81,28,73,33,61,125,135,296,194,2973,510,536,254,1631,361,1554,353,77,105,31,94,46,88,436,229,370,192
19003,3023,400,1502,233,336,158,950,175,901,174,49,52,11,34,38,48,66,47,150,75,1521,229,235,121,887,167,866,168,21,27,6,30,15,22,212,93,187,112
19005,11109,1945,5602,1210,1619,845,3315,833,3159,800,156,230,67,181,89,183,168,213,500,400,5507,1076,1013,612,3378,823,3276,808,102,190,46,169,56,163,619,460,497,342
19007,10179,1895,4979,1160,1435,784,2697,749,2558,722,139,197,33,131,106,183,149,188,698,435,5200,1115,1059,593,2654,761,2549,749,105,167,26,133,79,158,760,405,727,446
19009,4614,799,2246,432,510,274,1405,324,1340,313,65,115,20,88,45,101,101,97,230,154,2368,493,391,252,1368,331,1328,322,40,91,12,79,28,88,354,198,255,161
19011,20707,3192,10294,1850,2593,1154,6416,1411,6237,1389,179,272,126,279,53,196,251,297,1034,678,10413,1841,1867,953,6424,1416,6267,1391,157,262,115,259,42,197,1067,711,1055,659
19013,108176,19506,52659,12306,21023,9542,25603,7032,23774,6528,1829,2365,776,1578,1053,1861,1042,1609,4991,3748,55517,12028,19619,8665,25401,6955,24222,6634,1179,1854,579,1417,600,1444,4656,3379,5841,4068
19015,21714,3477,10822,2212,2967,1430,6257,1427,5913,1384,344,435,126,272,218,343,305,350,1293,824,10892,2007,1969,1035,6422,1474,6126,1465,296,342,139,271,157,265,1100,688,1401,916
19017,20328,2686,9959,1649,2785,1113,6185,1150,5969,1128,216,308,89,224,127,260,302,337,687,503,10369,1667,2629,1124,5834,1080,5694,1080,140,228,65,190,75,208,1062,601,844,527
19019,16418,2776,8102,1656,2486,1185,4674,1091,4472,1075,202,278,70,228,132,229,211,268,731,581,8316,1601,1750,913,4838,1167,4581,1118,257,325,134,259,123,263,813,494,915,565
19021,15764,2584,7882,1575,2573,1017,4432,1095,3977,942,455,486,116,236,339,400,242,252,635,430,7882,1499,1920,860,4490,1068,4028,966,462,451,233,323,229,288,754,376,718,512
19023,11833,1390,5840,864,1382,548,3707,633,3588,619,119,162,49,118,70,141,224,205,527,310,5993,795,1060,475,3759,635,3668,621,91,129,58,116,33,107,702,323,472,286
19025,8024,1100,4151,731,1100,482,2300,498,2151,475,149,158,44,120,105,122,169,140,582,247,3873,590,639,308,2278,469,2169,459,109,133,57,102,52,102,561,261,395,210
19027,16181,2884,7864,1800,2110,1201,4856,1185,4764,1159,92,223,18,215,74,231,191,278,707,542,8317,1653,1577,937,4944,1190,4762,1158,182,299,72,283,110,238,980,590,816,576
19029,10737,1983,5246,1237,1376,747,2972,858,2682,768,290,301,47,160,243,289,249,268,649,474,5491,1230,969,577,3093,923,2884,861,209,276,109,223,100,191,730,478,699,488
19031,14999,2848,7401,1633,2075,1003,4295,1201,4181,1186,114,215,48,211,66,193,209,277,822,603,7598,1655,1519,907,4423,1141,4243,1143,180,269,84,231,96,219,811,538,845,600
19033,35523,7564,17186,4447,5470,2988,9152,2943,8812,2897,340,639,146,521,194,534,673,872,1891,1502,18337,4517,4247,2475,9465,3179,8877,2958,588,841,273,650,315,648,2103,1473,2522,1874
19035,9332,1721,4687,1183,1324,866,2697,742,2525,713,172,245,78,175,94,188,125,190,541,405,4645,983,893,568,2575,743,2466,715,109,193,57,167,52,164,630,374,547,431
19037,9748,1773,4955,1096,1357,723,3028,726,2872,696,156,223,25,147,131,212,150,168,420,313,4793,1030,896,541,2946,708,2828,680,118,178,51,161,67,151,568,360,383,291
19039,7408,1518,3575,899,878,568,2217,652,2060,614,157,162,112,140,45,113,91,123,389,320,3833,847,646,408,2004,624,1904,605,100,158,65,137,35,92,411,293,772,409
19041,13150,2706,6432,1569,1731,999,3652,1172,3514,1148,138,267,72,215,66,215,305,374,744,657,6718,1642,1376,883,3760,1219,3532,1180,228,301,106,237,122,273,815,609,767,662
19043,14511,2460,7345,1532,2186,988,3907,909,3759,897,148,204,51,185,97,181,227,235,1025,623,7166,1284,1295,715,4109,966,3874,932,235,290,142,237,93,190,1007,537,755,472
19045,38052,8339,18515,4926,5433,3115,9980,3158,9519,3016,461,806,283,716,178,589,761,1072,2341,1962,19537,4824,4744,2776,9873,3146,9244,2929,629,924,391,803,238,608,2226,1512,2694,1977
19047,13545,3291,6845,1865,2211,1115,3954,1255,3662,1187,292,410,73,209,219,339,246,309,434,394,6700,2046,1810,1206,3629,1254,3395,1156,234,345,130,255,104,241,628,446,633,498
19049,66482,9844,32538,5789,8297,3533,21037,4324,20493,4271,544,825,214,610,330,669,589,888,2615,1917,33944,5731,7907,3452,20261,4174,19537,4102,724,959,302,658,422,732,2184,1596,3592,2114
19051,6716,1396,3340,785,924,460,2081,521,2014,519,67,110,22,77,45,111,72,98,263,207,3376,773,817,476,1899,485,1843,472,56,87,15,75,41,85,376,234,284,207
19053,6527,1007,3281,638,1064,421,1818,443,1708,426,110,121,69,107,41,80,72,78,327,207,3246,585,793,304,1752,413,1652,401,100,108,43,68,57,99,296,175,405,193
19055,13790,2720,6897,1669,1743,975,4279,1148,4217,1133,62,203,18,167,44,188,308,395,567,546,6893,1489,1225,797,4263,1124,4183,1120,80,209,12,178,68,209,806,576,599,531
19057,31958,6838,15354,4329,4875,3046,7991,2760,7331,2568,660,893,307,652,353,682,472,742,2016,1581,16604,4066,4321,2572,7975,2762,7468,2642,507,815,217,588,290,651,1812,1257,2496,1810
19059,14478,2273,7084,1413,1706,921,4224,980,4072,961,152,196,55,180,97,155,207,221,947,674,7394,1377,1224,741,4192,984,3960,924,232,271,125,234,107,184,839,463,1139,715
19061,78624,13490,38484,8100,13093,5793,21025,4990,20279,4847,746,1269,251,948,495,1107,995,1421,3371,2754,40140,8606,11757,5836,20521,4960,19600,4636,921,1452,358,1096,563,1190,3731,2577,4131,2921
19063,7859,1366,3892,821,1245,567,2036,568,1953,553,83,134,32,123,51,114,101,128,510,389,3967,854,1013,490,2082,595,1920,559,162,199,63,127,99,159,470,307,402,302
19065,16371,2685,8170,1655,2495,1119,4461,1038,4295,1008,166,293,83,256,83,245,235,253,979,623,8201,1565,1907,1017,4442,1029,4286,999,156,248,73,218,83,215,887,535,965,569
19067,12828,2676,6283,1624,1717,996,3704,1146,3460,1061,244,371,37,175,207,347,389,405,473,434,6545,1594,1447,891,3589,1101,3376,1022,213,328,127,265,86,218,703,460,806,629
19069,8184,1452,4036,856,1137,594,2463,643,2392,634,71,118,25,109,46,106,128,155,308,229,4148,834,825,470,2579,689,2420,635,159,193,94,162,65,139,392,268,352,276
19071,5694,805,2824,463,653,250,1657,335,1611,330,46,77,22,72,24,73,150,119,364,196,2870,456,443,209,1718,344,1660,334,58,90,20,75,38,81,412,183,297,161
19073,7273,1055,3539,624,918,379,2151,474,2019,465,132,138,79,124,53,79,97,93,373,230,3734,607,744,341,2062,474,1988,456,74,84,22,65,52,75,545,232,383,221
19075,9960,1278,4890,761,1157,480,3229,572,3151,571,78,120,31,115,47,116,126,132,378,254,5070,707,917,387,3123,572,3033,560,90,124,35,109,55,112,566,253,464,275
19077,8691,1288,4307,715,923,373,2773,543,2682,539,91,109,30,77,61,104,151,132,460,271,4384,738,726,390,2620,506,2524,500,96,118,36,75,60,98,508,252,530,292
19079,12120,2343,5956,1386,1637,844,3522,974,3321,943,201,268,86,213,115,224,165,212,632,509,6164,1420,1218,778,3632,1031,3519,998,113,232,88,214,25,165,697,443,617,486
19081,8858,1504,4420,898,1108,582,2811,669,2742,651,69,127,39,123,30,104,142,185,359,303,4438,851,747,426,2781,674,2717,665,64,110,7,113,57,120,540,301,370,271
19083,14316,2586,7128,1522,2283,1052,3930,992,3709,945,221,319,100,231,121,257,280,310,635,437,7188,1549,1470,831,4015,998,3863,981,152,236,50,184,102,235,1032,533,671,497
19085,11428,1585,5654,922,1393,551,3370,666,3235,646,135,169,36,119,99,153,190,172,701,401,5774,948,1193,532,3295,636,3178,627,117,166,30,128,87,156,721,367,565,335
19087,16353,2540,8365,1597,2757,1075,4626,1158,4127,1096,499,390,119,208,380,313,189,234,793,483,7988,1426,1974,1021,4259,1025,4115,1011,144,220,58,149,86,186,799,445,956,572
19089,7243,1392,3578,790,1037,550,2075,540,1974,510,101,148,72,154,29,80,91,118,375,275,3665,842,615,430,2230,591,2118,544,112,173,10,96,102,169,457,312,363,278
19091,7663,1055,3761,686,920,427,2276,506,2180,489,96,136,37,122,59,112,160,156,405,257,3902,599,684,347,2318,486,2177,501,141,145,82,130,59,115,507,267,393,254
19093,5546,718,2733,420,705,281,1599,280,1567,281,32,49,4,56,28,48,125,107,304,179,2813,416,531,233,1634,301,1589,303,45,76,27,65,18,77,358,182,290,164
19095,13110,2130,6441,1292,1785,879,3856,875,3792,868,64,137,29,132,35,114,197,257,603,403,6669,1237,1449,781,3997,923,3835,902,162,226,85,183,77,162,754,446,469,356
19097,15869,3048,7931,1863,2253,1164,4491,1213,4367,1186,124,268,42,230,82,250,273,331,914,698,7938,1667,1592,913,4553,1189,4263,1147,290,368,165,288,125,279,917,581,876,642
19099,30105,6046,15408,3632,4419,2162,8607,2369,7936,2259,671,668,188,451,483,561,371,492,2011,1323,14697,3346,2595,1584,8691,2376,8159,2248,532,750,293,579,239,520,1489,1074,1922,1386
19101,15805,4157,7769,2342,2909,1647,3281,1064,3103,1023,178,273,16,125,162,262,267,304,1312,934,8036,2531,2411,1821,3666,1255,3328,1132,338,377,162,299,176,272,797,659,1162,859
19103,123196,20105,60838,13265,27632,10869,28532,6888,26679,6389,1853,2089,553,1195,1300,1679,876,1334,3798,2996,62358,12556,26228,10086,27506,6500,25905,6212,1601,1931,600,1186,1001,1566,3015,2543,5609,3516
19105,16934,3064,8793,1766,2733,1125,4763,1239,4450,1193,313,323,60,215,253,293,305,321,992,722,8141,1810,1685,984,4753,1256,4601,1228,152,247,26,168,126,242,863,598,840,618
19107,8289,1350,4175,803,1075,493,2422,549,2294,529,128,170,73,157,55,105,141,144,537,269,4114,732,689,382,2512,555,2392,548,120,132,45,128,75,116,520,287,393,229
19109,12240,1911,6086,1148,1603,745,3656,821,3523,803,133,192,37,169,96,174,134,182,693,471,6154,1142,1214,637,3475,781,3327,762,148,199,55,162,93,178,810,499,655,427
19111,28061,5570,14110,3370,4323,2171,7723,2225,7264,2172,459,534,114,387,345,483,411,553,1653,1125,13951,3095,3084,1703,7665,2209,7284,2137,381,569,264,527,117,364,1386,963,1816,1225
19113,180390,32586,88203,20035,30667,14495,45983,11955,44156,11545,1827,2879,624,1882,1203,2414,2176,3053,9377,7050,92187,19307,25864,12949,47063,12182,44862,11537,2201,3186,1051,2263,1150,2382,8085,5908,11175,7471
19115,9155,1680,4642,969,1462,616,2539,602,2433,586,106,139,10,96,96,140,191,176,450,288,4513,896,914,478,2583,622,2432,608,151,170,88,146,63,121,497,313,519,291
19117,6967,1173,3456,710,861,438,2093,520,2028,521,65,129,18,77,47,132,128,153,374,245,3511,665,574,360,2093,528,1978,514,115,173,87,152,28,109,380,256,464,308
19119,8987,1429,4514,814,990,489,3000,618,2926,613,74,128,25,113,49,119,194,197,330,257,4473,813,729,412,3064,617,2935,598,129,171,21,116,108,167,478,275,202,173
19121,12774,2359,6347,1463,1314,749,4156,1045,4014,1038,142,214,70,186,72,135,295,307,582,479,6427,1288,1164,722,4160,1043,4028,1034,132,193,78,161,54,134,630,440,473,395
19123,17720,3324,8799,2039,2535,1299,4996,1294,4752,1256,244,349,140,297,104,266,240,348,1028,728,8921,1888,1821,1011,4946,1285,4728,1250,218,354,74,262,144,304,953,648,1201,761
19125,26834,4964,13296,2943,3752,1917,7773,2036,7466,1994,307,474,84,311,223,432,420,503,1351,996,13538,2999,3052,1692,7638,1984,7423,1956,215,402,87,319,128,344,1316,964,1532,955
19127,31502,7321,15854,4517,4879,2786,8570,2861,8028,2757,542,781,94,443,448,728,577,707,1828,1361,15648,4040,3602,2251,8761,2826,8262,2709,499,711,267,576,232,549,1583,1314,1702,1258
19129,12092,2193,6030,1312,1752,896,3438,754,3320,724,118,173,7,123,111,176,228,234,612,431,6062,1205,1404,703,3331,728,3189,707,142,175,78,151,64,153,679,513,648,419
19131,8589,1555,4174,896,1210,587,2462,630,2350,615,112,177,19,114,93,174,97,144,405,325,4415,931,819,502,2510,662,2308,633,202,231,56,151,146,198,609,359,477,313
19133,7261,1253,3466,746,936,436,2055,521,1937,503,118,157,52,143,66,123,183,183,292,231,3795,730,647,370,2073,559,1912,515,161,197,81,141,80,156,564,314,511,297
19135,6299,1294,3132,775,772,459,1982,565,1881,559,101,134,57,126,44,87,173,196,205,196,3167,685,615,417,1914,549,1809,535,105,142,54,116,51,95,355,221,283,221
19137,8194,1411,3949,862,1060,597,2350,633,2248,636,102,153,61,157,41,101,134,169,405,302,4245,835,798,470,2285,626,2155,634,130,166,49,137,81,144,574,334,588,361
19139,34044,7009,16833,4188,5399,2656,9288,2794,8674,2632,614,776,210,468,404,659,550,735,1596,1389,17211,4104,3931,2290,9494,2858,8810,2653,684,832,310,567,374,660,1637,1225,2149,1571
19141,11100,2124,5512,1269,1543,772,3351,894,3202,861,149,223,67,182,82,162,134,186,484,405,5588,1233,1056,752,3176,910,3027,871,149,230,102,220,47,136,918,516,438,355
19143,4882,769,2407,448,597,291,1502,372,1406,373,96,113,48,99,48,86,90,91,218,147,2475,448,457,222,1394,342,1348,339,46,70,35,69,11,53,334,159,290,200
19145,12834,2666,6729,1796,2317,1309,3461,1122,3174,971,287,365,75,237,212,318,207,292,744,527,6105,1388,1141,743,3396,973,3213,932,183,267,41,184,142,257,723,470,845,590
19147,7196,1215,3548,727,1077,470,1976,522,1880,523,96,140,23,92,73,134,142,132,353,224,3648,683,657,343,2088,555,1993,547,95,120,53,125,42,101,542,257,361,255
19149,19982,3418,9649,2009,2604,1312,6037,1422,5859,1413,178,296,52,231,126,260,237,315,771,556,10333,1961,2021,1068,6262,1427,6028,1390,234,350,59,237,175,314,1052,582,998,717
19151,5602,816,2734,468,663,313,1609,341,1579,341,30,61,16,72,14,65,129,115,333,190,2868,506,384,249,1759,406,1675,384,84,109,69,102,15,59,368,171,357,202
19153,378752,72692,184737,44195,65048,31093,95504,27157,88881,25264,6623,8560,2155,5108,4468,6831,4498,6558,19687,15575,194015,43949,57999,28108,94906,26707,87366,24565,7540,8967,3204,5711,4336,6729,13832,11200,27278,17917
19155,75121,15683,36563,9547,12084,6339,19320,5765,18288,5495,1032,1598,414,1220,618,1331,863,1373,4296,3224,38558,9175,10000,5547,19389,5674,18104,5434,1285,1800,643,1352,642,1346,3879,2793,5290,3644
19157,15432,2685,7384,1623,2309,1115,3931,1101,3724,1085,207,232,49,168,158,225,332,366,812,572,8048,1607,2426,946,3801,1084,3688,1074,113,199,52,168,61,172,892,584,929,586
19159,3989,609,1898,310,457,176,1157,243,1118,239,39,55,11,44,28,49,89,78,195,126,2091,389,358,181,1220,267,1121,247,99,119,23,60,76,110,288,154,225,124
19161,7983,1332,3916,775,956,458,2396,591,2318,580,78,156,20,148,58,146,126,167,438,310,4067,775,659,375,2469,605,2402,594,67,139,16,128,51,148,521,289,418,269
19163,138135,26573,67282,16331,23257,11943,35324,9647,33336,9062,1988,2798,642,1766,1346,2344,1909,2596,6792,5369,70853,15845,20146,10255,35179,9475,32568,8831,2611,3424,1146,2142,1465,2538,6128,4542,9400,6360
19165,9531,1798,4625,1041,1198,640,2742,742,2626,746,116,177,55,137,61,157,239,244,446,376,4906,1075,900,575,2774,750,2645,728,129,199,46,146,83,174,570,392,662,473
19167,26942,4562,13462,2889,4227,2034,8530,1898,8167,1852,363,531,76,290,287,502,241,379,464,542,13480,2628,3158,1648,8673,1980,8412,1926,261,448,149,388,112,310,1174,800,475,507
19169,83398,15294,43702,10344,23717,8980,17111,4807,15901,4422,1210,1654,372,948,838,1330,578,937,2296,1894,39696,9278,17535,7627,17283,4630,16620,4527,663,1107,256,825,407,899,2141,1822,2737,2189
19171,13697,2518,6773,1461,1975,910,3784,973,3541,906,243,306,78,212,165,290,251,264,763,455,6924,1426,1492,744,3826,958,3633,920,193,275,58,179,135,247,762,453,844,468
19173,4957,719,2468,425,601,244,1469,314,1403,303,66,95,16,77,50,90,111,98,287,150,2489,416,406,202,1512,324,1381,306,131,145,67,102,64,111,301,152,270,143
19175,10092,2109,4853,1278,1376,770,2705,845,2545,795,160,267,65,202,95,208,182,248,590,480,5239,1189,1315,659,2655,820,2423,736,232,276,108,200,124,227,510,383,759,504
19177,5798,977,2936,608,724,374,1781,421,1672,408,109,118,70,129,39,63,127,117,304,176,2862,543,526,284,1732,397,1661,388,71,93,39,82,32,82,333,180,271,195
19179,28502,6529,14020,3885,4380,2481,7563,2536,7182,2461,381,676,203,530,178,501,513,634,1564,1270,14482,3638,3310,2062,7672,2439,7068,2341,604,818,271,573,333,614,1534,1160,1966,1292
19181,39877,5390,19299,3294,5218,2159,11885,2253,11457,2189,428,551,94,305,334,512,450,535,1746,1177,20578,3262,4660,2023,11930,2252,11475,2199,455,569,150,341,305,481,1607,989,2381,1263
19183,17628,3292,8685,1924,2370,1184,5305,1374,5041,1290,264,355,97,233,167,288,234,286,776,621,8943,1822,1859,1026,5172,1325,4887,1284,285,307,116,230,169,241,888,529,1024,668
19185,5075,595,2493,332,590,201,1506,267,1457,260,49,72,32,64,17,46,117,83,280,123,2582,369,473,169,1433,257,1359,246,74,84,14,29,60,77,363,173,313,152
19187,30151,6070,15618,3937,5922,2669,7017,2275,6477,2114,540,658,144,402,396,630,544,672,2135,1676,14533,3515,3668,2034,6952,2271,6515,2164,437,619,253,538,184,436,1825,1245,2088,1421
19189,8718,1641,4303,1025,1524,697,2144,656,2087,646,57,156,4,136,53,154,176,236,459,331,4415,976,1126,580,2358,721,2264,697,94,178,36,140,58,168,551,324,380,325
19191,17242,2749,8490,1613,2864,1130,4749,1137,4608,1124,141,235,7,175,134,236,291,307,586,488,8752,1711,2582,1071,4604,1135,4399,1073,205,304,108,240,97,240,932,649,634,487
19193,80141,21272,39348,12388,14172,8222,19961,7717,18662,7276,1299,2160,749,1780,550,1431,964,1679,4251,3974,40793,12224,11525,7360,20296,7712,18986,7362,1310,2029,687,1624,623,1473,3958,3298,5014,4103
19195,6179,959,3106,545,917,373,1737,389,1661,375,76,108,27,90,49,108,115,136,337,194,3073,550,732,345,1623,361,1560,345,63,100,23,87,40,101,367,204,351,216
19197,10193,1756,5127,1063,1559,751,3015,762,2926,745,89,163,11,109,78,169,172,185,381,254,5066,1006,1002,572,2862,700,2738,683,124,171,58,146,66,148,701,389,501,371
20001,10220,1787,4977,1113,1511,813,2584,727,2462,712,122,184,61,139,61,167,195,219,687,473,5243,1064,1060,579,2755,765,2542,718,213,243,134,218,79,168,606,379,822,591
20003,6183,1112,3028,672,787,458,1780,492,1739,492,41,65,11,61,30,63,41,68,420,288,3155,651,531,351,1922,503,1818,501,104,109,36,69,68,99,370,246,332,268
20005,13153,3220,6241,1830,2286,1207,3112,1146,2986,1129,126,247,5,160,121,245,255,330,588,535,6912,2016,2175,1254,3117,1216,3018,1184,99,243,30,180,69,212,675,506,945,744
20007,3661,709,1858,417,470,231,1029,265,978,258,51,62,15,59,36,60,89,85,270,160,1803,406,323,185,1021,264,914,242,107,104,76,92,31,74,224,135,235,156
20009,21244,5400,10306,3066,3191,1898,5680,1995,5365,1921,315,539,65,312,250,508,326,508,1109,1080,10938,3169,2757,1872,5748,2034,5431,1972,317,518,171,420,146,407,1085,907,1348,1095
20011,11488,2806,5629,1685,1821,1127,3115,1074,3031,1067,84,196,26,156,58,185,190,256,503,463,5859,1555,1288,808,3234,1107,3068,1079,166,233,101,232,65,165,706,496,631,490
20013,7590,1219,3777,698,897,429,2260,520,2024,483,236,224,30,86,206,223,125,139,495,271,3813,733,613,331,2248,524,2066,516,182,191,50,83,132,183,436,259,516,282
20015,52799,8718,26564,5285,7548,3363,15334,3580,14458,3457,876,867,197,537,679,743,980,1054,2702,1805,26235,5172,5219,2871,15838,3615,15148,3520,690,907,281,619,409,707,2381,1800,2797,1901
20017,2127,337,1077,190,312,126,582,146,545,139,37,48,13,31,24,45,66,47,117,73,1050,219,191,117,583,143,550,137,33,44,24,39,9,40,193,84,83,51
20019,2702,538,1395,314,358,175,767,217,717,214,50,51,32,58,18,34,44,50,226,130,1307,293,229,125,722,207,707,207,15,38,11,36,4,46,180,105,176,110
20021,16266,3714,7937,2180,2034,1270,4593,1508,4431,1487,162,336,44,238,118,287,338,461,972,767,8329,2200,1745,1189,4332,1449,3972,1385,360,465,205,367,155,322,1065,718,1187,901
20023,2206,340,1063,193,238,120,627,148,600,144,27,39,2,36,25,38,38,46,160,95,1143,219,200,93,553,148,522,142,31,45,25,47,6,32,235,86,155,74
20025,1595,149,806,100,142,62,522,88,485,86,37,39,13,23,24,35,36,32,106,56,789,91,92,40,481,85,450,85,31,24,22,26,9,13,104,45,112,51
20027,6461,1398,3227,830,699,448,1932,630,1887,629,45,83,19,82,26,87,127,159,469,393,3234,838,560,451,1942,662,1862,634,80,142,55,125,25,101,407,343,325,281
20029,7180,1547,3529,937,984,618,2028,635,1965,636,63,140,11,122,52,138,130,161,387,298,3651,878,789,515,1891,581,1805,570,86,161,7,116,79,158,473,286,498,362
20031,6830,771,3465,463,796,296,2093,370,1949,353,144,125,68,98,76,99,137,131,439,229,3365,460,577,258,2013,358,1916,347,97,99,62,83,35,66,336,182,439,225
20033,1439,242,731,147,186,84,428,110,405,102,23,40,0,30,23,40,30,30,87,55,708,135,128,83,388,95,370,96,18,19,1,22,17,19,101,61,91,51
20035,28356,5570,14191,3391,4102,2105,7775,2291,6996,2049,779,882,218,477,561,731,531,618,1783,1283,14165,3279,3169,1920,7350,2140,6749,2008,601,718,306,551,295,498,1747,1131,1899,1305
20037,31817,6356,15804,4123,6762,3246,7023,2126,6594,2029,429,616,192,472,237,467,418,542,1601,1188,16013,3736,4769,2534,7638,2351,6887,2116,751,869,294,537,457,653,1521,1018,2085,1298
20039,2406,360,1181,208,243,128,679,182,666,182,13,25,0,40,13,25,86,75,173,110,1225,229,190,90,688,182,658,181,30,51,8,34,22,52,180,121,167,100
20041,15163,2791,7603,1707,1973,1038,4430,1222,4227,1184,203,288,81,201,122,256,231,294,969,700,7560,1614,1372,819,4417,1146,4234,1121,183,275,60,192,123,243,840,627,931,679
20043,6476,1080,3335,674,1118,400,1748,483,1623,436,125,145,28,88,97,141,84,104,385,222,3141,589,766,303,1616,425,1523,407,93,109,20,82,73,107,374,217,385,225
20045,101725,22003,50450,14471,24623,12009,21455,6200,20340,5924,1115,1613,200,842,915,1441,896,1325,3476,2888,51275,13161,21830,10540,21273,6323,20222,5989,1051,1645,250,901,801,1429,2932,2561,5240,3669
20047,2321,308,1161,170,225,116,709,151,661,154,48,46,18,35,30,33,61,45,166,92,1160,206,176,106,722,158,666,160,56,46,35,46,21,25,123,66,139,74
20049,2078,395,1009,232,199,100,610,167,578,160,32,37,15,42,17,31,55,47,145,91,1069,224,120,74,618,165,581,162,37,43,10,37,27,38,163,78,168,89
20051,23378,5840,11715,3929,5029,3089,5449,1890,5201,1797,248,473,45,276,203,444,250,435,987,1013,11663,3411,3902,2287,5425,1948,5014,1749,411,659,189,441,222,458,1236,1028,1100,1018
20053,5293,738,3036,543,932,349,1632,366,1349,321,283,146,103,120,180,94,123,126,349,200,2257,368,403,199,1264,286,1228,280,36,63,23,66,13,53,325,198,265,143
20055,27264,6477,13981,3947,4847,2465,7420,2512,6435,2133,985,1057,287,540,698,845,406,594,1308,1140,13283,3691,3856,2339,7199,2292,6562,2179,637,761,365,585,272,500,1180,969,1048,959
20057,25437,6724,13298,4104,4429,2477,7345,2526,6680,2397,665,728,232,446,433,591,303,508,1221,1117,12139,3629,3004,2118,6892,2449,6205,2269,687,749,303,502,384,587,970,877,1273,1129
20059,20478,4375,10003,2578,2692,1543,5795,1728,5517,1701,278,416,76,272,202,358,312,417,1204,926,10475,2526,2335,1462,5835,1761,5577,1708,258,370,75,245,183,336,872,663,1433,996
20061,24635,5433,13257,3590,3231,1934,8819,2747,7760,2372,1059,1181,166,391,893,1087,207,432,1000,914,11378,2831,2207,1583,7287,2066,6488,1918,799,773,232,453,567,653,757,714,1127,1025
20063,2146,212,1041,126,172,72,748,100,734,99,14,13,7,12,7,26,43,34,78,46,1105,142,147,63,722,120,687,126,35,28,13,26,22,22,133,68,103,54
20065,2088,271,1016,169,185,90,682,141,620,136,62,61,31,50,31,47,56,66,93,64,1072,161,165,86,592,131,577,132,15,40,8,45,7,31,155,73,160,82
20067,5470,1448,2871,964,925,668,1672,617,1588,595,84,146,0,70,84,146,82,165,192,257,2599,838,541,463,1612,609,1497,589,115,165,32,97,83,131,177,234,269,308
20069,4569,783,2252,454,551,270,1420,304,1376,303,44,90,7,70,37,89,111,100,170,142,2317,435,480,226,1506,316,1440,308,66,84,25,87,41,62,217,150,114,99
20071,929,146,467,86,87,47,316,73,294,71,22,21,9,14,13,15,29,19,35,27,462,85,61,38,293,66,281,66,12,18,12,18,0,20,82,50,26,22
20073,5009,883,2512,502,604,284,1448,375,1370,363,78,100,37,92,41,80,94,106,366,214,2497,524,419,222,1369,371,1272,348,97,121,46,89,51,109,288,187,421,214
20075,1971,305,1058,200,321,135,645,142,526,117,119,86,79,80,40,38,33,24,59,54,913,171,279,128,474,121,424,111,50,51,47,49,3,18,77,55,83,59
20077,4434,731,2218,471,574,304,1327,303,1250,292,77,111,12,55,65,115,105,109,212,119,2216,392,321,164,1336,328,1218,312,118,111,68,85,50,80,312,159,247,142
20079,27707,6314,13644,3900,4194,2682,8058,2438,7824,2369,234,420,57,303,177,386,368,524,1024,955,14063,3616,3309,2142,7526,2240,7285,2196,241,430,123,348,118,343,1463,1070,1765,1384
20081,3079,481,1544,284,455,182,966,208,903,201,63,59,56,56,7,22,29,46,94,82,1535,263,334,147,911,196,874,197,37,54,17,52,20,42,164,114,126,76
20083,1556,112,782,61,179,49,525,53,494,57,31,20,8,8,23,17,8,8,70,28,774,70,108,37,507,54,489,55,18,13,15,12,3,4,113,41,46,18
20085,10549,1794,5226,1009,1406,609,3106,763,3017,760,89,126,19,92,70,114,184,191,530,350,5323,1006,1031,479,3000,735,2887,726,113,146,34,85,79,123,515,298,777,412
20087,15390,2644,7730,1613,1903,971,4800,1122,4655,1106,145,210,34,164,111,188,187,235,840,503,7660,1405,1311,660,4725,1072,4552,1034,173,229,75,163,98,193,765,448,859,523
20089,2424,304,1226,192,254,111,754,148,719,145,35,42,14,31,21,30,57,38,161,86,1198,165,133,65,782,153,752,150,30,43,16,37,14,36,164,82,119,65
20091,471203,82116,228660,50712,69249,35838,136288,31739,130237,30338,6051,8614,2129,5589,3922,7106,4384,6977,18739,15491,242543,48274,60858,31108,136432,31336,129843,30122,6589,8890,2511,5972,4078,7091,17113,13267,28140,18561
20093,2969,551,1444,328,460,236,841,227,811,227,30,51,12,40,18,38,65,68,78,74,1525,314,391,220,867,188,778,181,89,85,9,34,80,84,164,120,103,88
20095,6035,1010,2976,601,596,290,1921,480,1867,468,54,90,6,69,48,97,167,163,292,216,3059,567,491,285,1817,448,1780,452,37,93,17,84,20,76,419,235,332,199
20097,2032,316,1002,185,286,136,579,121,562,118,17,36,2,33,15,34,74,61,63,48,1030,177,199,95,615,136,607,136,8,27,5,30,3,28,129,58,87,56
20099,16163,3492,7918,2212,2366,1449,4511,1365,4380,1342,131,249,60,233,71,221,232,317,809,661,8245,1884,1827,963,4269,1251,4107,1221,162,282,108,260,54,223,1022,660,1127,794
20101,1260,245,657,150,207,84,408,114,396,113,12,24,0,30,12,24,17,20,25,28,603,133,99,66,367,107,352,105,15,37,15,37,0,30,84,59,53,43
20103,64729,12434,34967,7854,11150,5143,18407,4711,16214,4237,2193,1703,573,884,1620,1440,955,1195,4455,3055,29762,6993,6466,4026,16569,4319,15401,4020,1168,1522,515,973,653,1083,2487,1945,4240,2972
20105,2483,415,1277,252,388,153,692,176,670,173,22,46,6,38,16,43,18,38,179,100,1206,223,198,106,670,179,608,143,62,93,33,62,29,62,189,92,149,83
20107,7891,1542,3920,914,844,482,2389,725,2293,712,96,151,26,91,70,146,243,234,444,314,3971,877,663,419,2378,696,2257,701,121,144,101,136,20,82,514,300,416,268
20109,2240,312,1104,187,307,110,646,132,609,129,37,46,11,25,26,44,21,26,130,82,1136,185,212,113,647,138,625,140,22,32,2,23,20,39,166,68,111,71
20111,27015,6477,12894,3823,4553,2686,6712,2241,6333,2158,379,574,81,352,298,529,370,532,1259,1116,14121,3774,4691,2527,7122,2348,6538,2225,584,799,356,625,228,512,994,806,1314,1088
20113,23276,4695,11412,2729,2975,1597,7080,2100,6788,2096,292,486,95,348,197,396,414,534,943,886,11864,2801,2394,1361,6855,2067,6510,2009,345,482,155,398,190,365,1358,999,1257,947
20115,9842,1465,4875,919,1373,556,2808,622,2730,600,78,148,15,119,63,146,226,238,468,296,4967,882,965,447,2813,612,2692,603,121,166,40,122,81,176,684,328,505,330
20117,7807,1146,3898,669,982,444,2357,492,2271,484,86,110,29,98,57,105,184,179,375,263,3909,699,720,383,2310,478,2207,469,103,135,53,119,50,106,534,301,345,238
20119,3329,427,1644,257,423,163,1014,199,956,190,58,71,9,42,49,69,56,61,151,98,1685,262,303,129,1036,197,928,193,108,73,68,60,40,50,179,96,167,91
20121,26655,6189,13298,3745,3291,2205,8117,2534,7674,2430,443,616,143,419,300,496,397,593,1493,1339,13357,3520,2639,1948,7698,2326,7503,2283,195,455,73,364,122,380,1379,1117,1641,1362
20123,4978,968,2524,619,872,437,1261,392,1233,390,28,70,7,52,21,63,79,103,312,222,2454,555,456,289,1297,387,1258,378,39,81,3,64,36,80,376,237,325,230
20125,26031,5747,12806,3497,3937,2244,6649,2165,6188,2073,461,642,171,452,290,519,446,605,1774,1324,13225,3276,2959,1793,6735,2155,6086,2025,649,775,372,615,277,517,1882,1209,1649,1218
20127,4564,819,2264,463,555,244,1469,350,1416,345,53,90,12,77,41,86,95,113,145,115,2300,481,388,216,1374,339,1338,336,36,62,6,70,30,67,286,190,252,154
20129,2201,427,1020,214,263,120,612,175,495,157,117,113,0,30,117,113,57,46,88,72,1181,273,345,168,609,170,601,169,8,21,5,26,3,25,132,90,95,92
20131,7911,1044,3948,621,1032,413,2460,484,2347,476,113,130,35,89,78,111,119,113,337,211,3963,620,731,332,2422,480,2335,473,87,121,38,105,49,97,532,263,278,186
20133,12799,3080,6303,1799,1615,994,3536,1226,3331,1201,205,308,116,247,89,222,289,332,863,737,6496,1728,1379,892,3401,1163,3245,1161,156,264,82,212,74,222,764,598,952,630
20135,2346,304,1195,201,222,123,836,155,802,149,34,34,4,27,30,39,46,36,91,66,1151,167,92,52,791,148,756,147,35,35,10,31,25,32,146,83,122,80
20137,4573,971,2579,626,915,354,1095,397,914,370,181,122,41,76,140,108,95,113,474,335,1994,554,407,268,949,385,904,372,45,79,7,45,38,71,411,251,227,185
20139,12873,2015,6389,1179,1517,698,3715,848,3546,832,169,207,77,152,92,187,185,194,972,523,6484,1162,1178,600,3899,862,3616,820,283,279,149,205,134,187,567,355,840,464
20141,2910,406,1446,255,341,160,839,164,795,155,44,56,7,21,37,54,51,35,215,117,1464,218,258,126,850,158,810,158,40,44,28,36,12,44,241,116,115,72
20143,4779,819,2423,494,681,341,1502,305,1451,301,51,68,13,58,38,56,49,66,191,118,2356,422,357,207,1444,295,1411,297,33,52,12,47,21,54,302,146,253,154
20145,5728,1344,3259,855,1242,574,1363,528,1147,481,216,164,39,84,177,158,64,100,590,358,2469,815,511,417,1285,500,1229,487,56,113,20,80,36,103,288,256,385,357
20147,4351,646,2140,373,433,193,1317,295,1252,281,65,83,19,63,46,83,95,88,295,169,2211,400,434,242,1312,280,1271,272,41,88,23,71,18,88,230,153,235,143
20149,17971,2885,9040,1723,2258,1051,5765,1262,5541,1201,224,345,154,310,70,179,204,280,813,623,8931,1661,1944,940,5591,1175,5423,1155,168,240,31,128,137,229,795,582,601,479
20151,7403,1324,3641,780,1054,547,2007,550,1820,498,187,246,33,113,154,225,145,186,435,300,3762,825,687,402,2139,546,1933,537,206,209,103,166,103,139,400,299,536,383
20153,2070,277,1039,147,211,95,708,140,690,137,18,28,18,28,0,30,12,23,108,60,1031,162,163,80,671,127,650,130,21,30,14,36,7,20,139,55,58,36
20155,51026,11085,25543,6625,8225,4406,13438,4089,12573,3837,865,1106,256,746,609,990,736,981,3144,2311,25483,6296,5706,3573,13324,4089,12563,3848,761,1114,377,881,384,823,2731,1929,3722,2624
20157,3856,610,1841,372,382,219,1243,313,1195,308,48,66,26,57,22,64,82,76,134,96,2015,364,213,152,1303,312,1207,309,96,118,14,71,82,110,312,170,187,123
20159,7821,1468,3981,900,1283,611,2237,630,2119,621,118,143,17,94,101,142,133,126,328,267,3840,849,693,397,2283,619,2212,601,71,130,20,103,51,115,488,318,376,249
20161,64458,13427,34382,9273,19512,7923,11857,3771,10793,3317,1064,1498,438,912,626,1082,524,913,2489,2138,30076,8287,13638,6291,12271,3699,11262,3411,1009,1320,172,652,837,1181,1563,1464,2604,2110
20163,4135,533,2005,319,523,194,1131,227,1050,220,81,76,38,71,43,42,107,91,244,128,2130,299,364,138,1256,261,1189,256,67,59,35,45,32,53,308,126,202,98
20165,2489,363,1228,208,372,136,629,145,614,145,15,31,0,40,15,31,74,48,153,79,1261,213,218,104,700,166,645,161,55,60,25,35,30,51,190,82,153,76
20167,5725,1606,2818,984,799,602,1602,657,1497,647,105,174,12,79,93,166,29,89,388,304,2907,907,501,399,1725,726,1676,731,49,113,41,127,8,63,340,305,341,304
20169,44002,9869,21722,6041,7026,4170,11602,3740,10984,3564,618,998,187,632,431,816,503,841,2591,2062,22280,5737,5065,3367,11763,3753,10978,3616,785,1081,373,787,412,814,2123,1769,3329,2448
20171,3803,1141,1920,642,565,396,1197,487,1164,485,33,75,6,60,27,69,27,86,131,161,1883,638,313,272,1259,521,1245,517,14,63,0,60,14,63,153,173,158,184
20173,402262,86440,197051,52263,68431,35970,100398,30486,93384,28261,7014,9571,2690,6192,4324,7325,5452,7787,22770,17914,205211,51284,57666,31748,102496,30866,93296,28092,9200,11137,4243,7522,4957,7901,16983,13432,28066,19567
20175,16323,4308,8330,2755,3325,1896,4109,1616,3741,1493,368,473,89,221,279,430,159,318,737,679,7993,2226,2400,1324,3932,1495,3464,1344,468,612,161,330,307,482,862,675,799,669
20177,142722,29331,68226,17343,21398,11429,36523,10946,34663,10486,1860,2809,698,1980,1162,2244,2514,3145,7791,6005,74496,17440,19177,10293,37175,11040,34958,10385,2217,3109,864,2048,1353,2419,7213,5507,10931,7033
20179,2021,332,1021,186,215,106,668,163,591,152,77,80,15,42,62,72,36,37,102,70,1000,195,150,88,607,150,593,150,14,32,10,35,4,20,144,78,99,64
20181,4762,1472,2400,868,754,469,1305,653,1261,636,44,87,22,89,22,65,145,212,196,258,2362,848,424,367,1293,599,1283,599,10,74,1,73,9,81,344,308,301,366
20183,3043,434,1504,277,293,152,1055,211,1016,197,39,61,2,43,37,68,47,43,109,71,1539,231,232,115,950,188,936,188,14,20,7,40,7,21,193,86,164,107
20185,3389,391,1708,239,372,138,1059,172,1008,173,51,58,9,43,42,52,114,71,163,88,1681,213,252,103,1018,170,966,167,52,57,21,40,31,51,204,89,207,89
20187,1531,256,751,179,215,137,490,131,465,125,25,34,0,20,25,34,7,12,39,41,780,148,223,86,404,113,385,114,19,24,6,20,13,16,90,52,63,59
20189,4207,918,2169,612,701,412,1217,414,1100,352,117,196,46,104,71,137,62,92,189,168,2038,505,456,302,1249,375,1110,340,139,164,60,101,79,118,186,137,147,129
20191,18403,3736,9111,2195,2454,1235,5199,1458,4979,1413,220,334,101,285,119,275,444,522,1014,761,9292,2161,1651,985,5240,1514,4906,1446,334,439,106,294,228,384,1339,865,1062,747
20193,6301,1336,2978,790,979,571,1697,545,1669,549,28,69,3,58,25,64,102,135,200,175,3323,822,893,463,1952,615,1881,609,71,113,19,88,52,95,221,197,257,237
20195,2464,493,1231,289,246,152,773,206,747,208,26,54,3,46,23,53,72,91,140,121,1233,283,225,134,708,206,692,198,16,55,4,40,12,65,203,107,97,87
20197,5539,1041,2775,631,717,358,1575,385,1512,376,63,96,14,68,49,95,113,127,370,239,2764,576,469,262,1681,399,1605,399,76,103,44,92,32,82,367,203,247,154
20199,1229,152,607,88,156,56,389,69,384,71,5,7,3,14,2,13,18,18,44,28,622,87,95,38,397,80,390,79,7,8,0,20,7,8,81,34,49,30
20201,4462,750,2260,455,561,256,1391,328,1302,305,89,90,8,61,81,95,105,88,203,133,2202,406,468,240,1308,278,1250,283,58,67,12,49,46,77,289,140,137,95
20203,1752,380,808,214,154,128,583,173,546,168,37,51,11,38,26,38,18,25,53,51,944,237,237,137,611,183,567,180,44,66,23,47,21,49,68,60,28,47
20205,6969,844,3404,480,860,292,1937,392,1823,388,114,103,68,86,46,72,145,102,462,240,3565,550,576,258,1969,394,1831,392,138,136,122,129,16,57,527,226,493,256
20207,2586,125,1318,91,361,93,699,88,667,87,32,33,15,23,17,18,61,35,197,66,1268,87,194,55,672,82,627,82,45,30,14,15,31,27,221,67,181,65
20209,125833,30275,61671,18477,24812,12917,28257,10552,25354,9660,2903,3642,1298,2502,1605,2761,1655,2624,6947,5662,64162,17634,21736,11617,28986,10614,25299,9561,3687,4332,1847,3034,1840,3045,5326,4554,8114,6075
21001,16191,3335,7916,2029,2610,1316,4323,1216,4006,1148,317,390,93,223,224,337,126,218,857,690,8275,1930,2157,1171,4153,1155,3928,1144,225,306,144,266,81,203,1115,759,850,622
21003,16780,3546,8318,2069,2382,1278,4446,1382,4291,1357,155,266,78,211,77,213,352,394,1138,849,8462,2063,1862,1107,4486,1395,4222,1329,264,372,33,175,231,354,894,644,1220,904
21005,18027,3725,8706,2139,2401,1376,4852,1425,4514,1316,338,475,68,215,270,418,250,316,1203,822,9321,2121,1828,1064,4661,1414,4461,1358,200,297,192,297,8,143,830,621,2002,1157
21007,6588,1372,3239,806,924,468,1786,538,1686,514,100,138,49,119,51,102,100,117,429,288,3349,782,738,396,1732,518,1626,491,106,131,28,75,78,118,376,238,503,288
21009,35237,8291,16701,4763,4695,3051,9243,3067,8595,2920,648,856,274,577,374,689,488,685,2275,1842,18536,4944,4034,2743,9506,3162,8445,2860,1061,1280,678,979,383,740,2060,1391,2936,2087
21011,9702,1947,4779,1104,1226,644,2941,832,2726,814,215,253,122,184,93,180,75,125,537,410,4923,1110,912,552,2781,819,2553,779,228,235,125,182,103,146,550,374,680,401
21013,22042,5915,10727,3366,2973,1803,5639,2150,4876,2012,763,774,443,572,320,518,425,660,1690,1273,11315,3445,2224,1511,5916,2262,5192,2114,724,847,377,561,347,588,1695,1270,1480,1187
21015,102258,18033,50397,10887,14640,7360,29793,6905,28206,6653,1587,1965,574,1138,1013,1581,1004,1445,4960,3843,51861,10477,13088,6717,28523,6807,27019,6385,1504,2030,700,1374,804,1411,3662,2912,6588,4179
21017,16271,3205,7787,1931,2385,1197,4095,1258,3889,1204,206,324,117,258,89,241,278,331,1029,772,8484,1842,1943,1189,4238,1232,3893,1187,345,457,216,366,129,269,983,704,1320,881
21019,39331,8852,19554,5390,5844,3451,10200,3255,9026,2977,1174,1232,366,661,808,988,724,884,2786,1894,19777,5247,4104,2615,10014,3225,9273,3025,741,961,467,781,274,613,2224,1634,3435,2247
21021,25051,4754,12361,2951,4484,2047,5936,1742,5485,1641,451,498,220,395,231,362,340,446,1601,1055,12690,2728,3405,1544,5901,1681,5335,1580,566,563,352,456,214,364,1425,931,1959,1203
21023,6659,1203,3333,710,866,422,1868,513,1716,486,152,166,76,123,76,112,147,150,452,306,3326,675,644,358,1824,485,1700,461,124,169,60,121,64,116,437,269,421,272
21025,10811,2066,5402,1257,1713,828,2845,829,2598,790,247,283,125,210,122,209,149,191,695,447,5409,1175,1132,618,3032,839,2643,779,389,345,268,283,121,185,639,365,606,414
21027,16408,3388,8190,1974,2202,1074,4584,1310,4230,1222,354,368,123,228,231,306,315,360,1089,734,8218,1910,1594,929,4363,1234,4130,1199,233,302,146,251,87,216,1028,692,1233,739
21029,65926,12250,32506,7112,9280,4596,18414,4496,17595,4378,819,1036,272,721,547,916,1027,1203,3785,2621,33420,7310,7615,3975,18594,4588,17284,4275,1310,1529,685,1118,625,1033,2987,2216,4224,2851
21031,10403,1540,5189,927,1273,567,3069,730,2798,681,271,276,133,179,138,215,175,200,672,432,5214,935,963,493,3044,683,2662,642,382,327,167,211,215,255,497,329,710,427
21033,10322,2809,5045,1714,1543,1051,2727,1135,2707,1130,20,140,15,141,5,131,154,209,621,586,5277,1570,705,590,3196,1233,2914,1197,282,367,155,271,127,238,767,621,609,554
21035,32950,7494,15915,4386,5990,2886,7958,2511,7253,2440,705,859,232,514,473,704,427,658,1540,1365,17035,4547,5765,2730,7798,2499,6947,2280,851,1053,400,699,451,738,1615,1347,1857,1395
21037,76621,14105,37199,8582,13101,5855,18785,5196,17918,4984,867,1322,223,924,644,1183,1230,1495,4083,3090,39422,8512,11894,5540,18731,5135,17518,4834,1213,1699,656,1307,557,1178,3417,2659,5380,3578
21039,3865,523,1846,285,419,166,1095,214,1041,214,54,54,24,43,30,48,104,79,228,125,2019,344,338,155,1176,250,1082,244,94,78,41,51,53,71,273,167,232,124
21041,8293,1902,4255,1148,1216,718,2299,838,1935,722,364,433,77,137,287,377,112,159,628,465,4038,1163,752,507,2199,833,1897,732,302,341,195,259,107,202,522,407,565,415
21043,22137,5397,10748,3329,3143,2097,5610,1842,5125,1685,485,654,368,576,117,307,506,639,1489,1245,11389,3140,2654,1756,5618,1869,5299,1764,319,470,190,362,129,342,1511,1073,1606,1217
21045,12950,3079,6234,1746,1940,1007,3191,1117,2867,1039,324,383,110,231,214,306,188,271,915,692,6716,1836,1235,814,3572,1246,3195,1154,377,441,167,298,210,323,918,631,991,730
21047,54608,11990,29255,7833,10874,5121,14550,4734,13216,4370,1334,1332,493,870,841,1068,763,1048,3068,2371,25353,6479,6143,3778,13379,4072,11940,3768,1439,1527,749,1124,690,1007,2352,1675,3479,2400
21049,29314,5740,13946,3349,3945,2093,7807,2174,7281,2082,526,680,399,618,127,345,540,617,1654,1227,15368,3360,3403,1989,7616,2133,7047,2024,569,679,400,593,169,391,1607,1067,2742,1591
21051,16745,4139,8838,2484,2778,1411,4604,1676,3873,1496,731,633,346,457,385,433,461,544,995,843,7907,2304,1409,932,4542,1570,3870,1451,672,671,465,549,207,356,1023,831,933,778
21053,8286,1690,4120,1006,1375,670,1902,565,1763,544,139,187,34,81,105,174,217,221,626,405,4166,975,841,476,2126,606,1967,598,159,170,79,112,80,139,579,350,620,383
21055,7338,1539,3699,947,991,530,1995,649,1933,641,62,130,44,131,18,97,168,159,545,390,3639,880,625,444,1937,597,1802,581,135,171,107,170,28,100,571,359,506,365
21057,5455,1513,2610,842,631,418,1332,531,1272,529,60,113,13,90,47,107,168,179,479,387,2845,935,703,500,1393,562,1288,539,105,130,46,101,59,107,445,351,304,262
21059,79962,15183,38561,9420,11473,5980,20943,6012,19608,5697,1335,1714,704,1333,631,1149,1178,1488,4967,3688,41401,8872,9985,5459,21073,6020,19672,5700,1401,1807,919,1460,482,1097,3869,2793,6474,3994
21061,10331,2399,5214,1532,1342,873,2862,940,2498,817,364,462,260,357,104,211,295,338,715,610,5117,1280,757,561,2955,958,2768,902,187,266,132,226,55,144,642,452,763,544
21063,6374,1806,3685,1175,1278,627,1534,626,1159,572,375,286,185,201,190,191,194,216,679,363,2689,960,445,427,1749,746,1672,728,77,147,46,126,31,109,264,220,231,243
21065,11694,2716,5739,1613,1813,997,2723,937,2423,860,300,368,181,270,119,224,163,240,1040,745,5955,1592,1293,852,2683,937,2298,860,385,419,225,306,160,268,806,481,1173,820
21067,264087,50159,128303,31703,53143,24082,59202,17335,53863,16017,5339,6076,2259,4165,3080,4475,2972,4321,12986,9891,135784,30916,49360,22231,59002,17141,54625,16022,4377,5542,2174,4014,2203,4022,9195,7425,18227,11287
21069,11561,2138,5682,1243,1266,696,3564,936,3384,911,180,231,131,208,49,141,179,265,673,436,5879,1189,1179,618,3412,901,3306,897,106,191,80,165,26,141,598,453,690,495
21071,29912,9714,14395,5503,3864,3011,8083,3566,7390,3386,693,1027,412,788,281,694,568,925,1880,1789,15517,5430,2926,2454,8455,3709,7620,3481,835,1116,663,1013,172,565,1847,1644,2289,2046
21073,41729,9109,19956,5641,6357,3580,10415,3587,9350,3302,1065,1353,501,903,564,928,578,872,2606,1996,21773,5595,6266,3520,9219,3226,8596,3033,623,942,334,702,289,669,2362,1846,3926,2649
21075,4980,1171,2485,732,972,498,1017,418,878,371,139,163,80,146,59,122,131,161,365,294,2495,721,709,436,1054,439,893,396,161,189,137,179,24,114,414,286,318,270
21077,6987,906,3534,522,1076,314,1802,358,1570,346,232,155,78,78,154,129,87,75,569,266,3453,517,833,293,1733,361,1578,344,155,123,65,86,90,92,352,193,535,232
21079,14205,2591,6769,1507,1484,853,4353,1122,3932,1020,421,471,178,282,243,334,180,245,752,606,7436,1558,1222,760,4338,1077,3938,1019,400,402,214,281,186,279,756,523,1120,740
21081,19356,4274,9609,2376,2926,1539,5350,1733,4830,1578,520,583,250,419,270,377,193,305,1140,830,9747,2541,2235,1419,5085,1598,4693,1554,392,445,218,358,174,304,866,693,1561,981
21083,29935,7041,14512,4083,4414,2743,7849,2614,7235,2359,614,896,296,574,318,650,430,645,1819,1480,15423,4125,3248,2189,8397,2672,7647,2529,750,942,387,635,363,638,1778,1322,2000,1443
21085,21128,5070,10434,2962,2720,1683,5756,1957,5372,1873,384,496,179,368,205,398,439,519,1519,1171,10694,3024,2117,1567,5736,1925,5215,1827,521,619,274,461,247,468,1265,929,1576,1106
21087,9098,1819,4459,1075,1130,639,2495,729,2277,698,218,260,106,178,112,212,195,209,639,485,4639,1095,807,550,2402,687,2278,675,124,192,39,128,85,185,681,412,749,487
21089,29235,6032,14077,3469,3551,2028,8370,2294,7867,2210,503,651,288,502,215,457,529,644,1627,1169,15158,3393,2805,1658,8490,2403,7958,2288,532,675,285,496,247,496,1946,1182,1917,1245
21091,6945,1110,3520,667,879,377,2149,456,2083,450,66,88,23,69,43,85,82,101,410,261,3425,584,671,310,2196,460,2122,449,74,93,28,82,46,88,212,145,346,223
21093,86371,19013,42773,11663,13244,7251,23385,7250,21262,6615,2123,2284,767,1463,1356,1671,1232,1759,4912,3798,43598,10625,10113,6080,23081,6967,21381,6595,1700,2087,870,1517,830,1468,4190,3072,6214,4228
21095,21584,5473,10311,3050,2637,1592,6014,2205,5570,2100,444,613,181,460,263,469,384,530,1276,1064,11273,3203,2174,1469,6166,2256,5524,2107,642,734,373,545,269,516,1424,998,1509,1164
21097,15287,3152,7493,1901,2121,1228,4389,1307,4155,1221,234,344,182,312,52,179,302,350,681,541,7794,1752,1661,1036,4356,1245,4150,1204,206,310,158,277,48,189,855,633,922,669
21099,14892,3270,7252,1827,1754,1005,4076,1254,3712,1165,364,398,151,279,213,279,296,348,1126,753,7640,1885,1539,961,4031,1236,3802,1181,229,310,131,258,98,243,958,615,1112,700
21101,37067,7603,17701,4485,5132,2725,9534,3037,8912,2948,622,768,202,495,420,643,713,832,2322,1740,19366,4589,4376,2397,9935,3158,9015,2943,920,1018,481,695,439,708,1960,1376,3095,1919
21103,12840,2429,6276,1401,1830,790,3503,943,3324,932,179,239,106,192,73,174,190,259,753,523,6564,1360,1297,704,3641,970,3368,942,273,309,145,231,128,219,763,476,863,548
21105,3789,1016,1798,642,494,323,968,470,823,411,145,180,49,96,96,145,52,89,284,242,1991,600,521,367,887,376,803,377,84,94,58,80,26,69,375,259,208,153
21107,36704,7913,17635,4601,4640,2720,10057,3085,9482,2974,575,839,376,725,199,534,601,802,2337,1708,19069,4625,3478,2182,10284,3206,9453,3027,831,989,581,818,250,635,2178,1650,3129,2004
21109,10890,3015,5351,1721,1133,812,3112,1242,2838,1174,274,382,209,315,65,172,223,307,883,730,5539,1609,704,566,3255,1246,2782,1150,473,513,293,351,180,287,858,608,722,610
21111,624733,135810,297865,82783,112850,59006,141995,46197,129567,42141,12428,16163,4861,10076,7567,12792,8959,12318,34061,27157,326868,82496,103571,55407,144563,46546,129597,41699,14966,18029,7349,12254,7617,12754,30125,22499,48609,31913
21113,42291,9295,20168,5517,6426,3757,10965,3175,10310,3054,655,893,315,613,340,617,481,699,2296,1774,22123,5310,5856,3136,10752,3200,10052,2999,700,1049,294,636,406,724,2014,1544,3501,2310
21115,18418,4860,8976,2653,2227,1431,5170,1850,4804,1777,366,520,160,329,206,387,320,433,1259,990,9442,2788,1716,1285,5179,1889,4634,1724,545,675,300,513,245,439,1063,830,1484,1152
21117,132340,24692,64915,15231,23117,10914,32357,8905,30255,8378,2102,2821,944,2011,1158,2080,1675,2275,7766,5872,67425,14870,20019,9896,32281,8812,30004,8323,2277,2869,1342,2284,935,1862,5689,4235,9436,6208
21119,12742,2775,6225,1644,1724,926,3547,1161,3335,1116,212,281,126,225,86,213,267,298,687,588,6517,1662,1191,710,3535,1150,3318,1147,217,296,127,233,90,206,930,647,861,648
21121,25335,7423,12220,4317,3799,2504,6227,2656,5840,2542,387,629,183,456,204,494,494,705,1700,1474,13115,4509,2745,2035,6832,2785,5782,2517,1050,1256,737,1018,313,607,1710,1372,1828,1773
21123,11606,2611,5725,1564,1476,839,3292,1145,3049,1118,243,309,58,179,185,254,305,385,652,503,5881,1663,1115,717,3134,1098,2868,1067,266,341,162,279,104,201,848,680,784,649
21125,48999,11534,23727,6687,6036,3596,13577,4359,12243,4015,1334,1421,603,892,731,1075,778,988,3336,2517,25272,6623,5228,3440,13883,4338,11834,3887,2049,1972,1218,1434,831,1236,2585,1867,3576,2607
21127,12533,3159,6108,1808,1673,1033,3310,1151,3110,1114,200,273,122,212,78,210,339,349,786,637,6425,1756,1243,856,3611,1235,3216,1149,395,397,236,326,159,270,887,592,684,537
21129,5742,1304,3026,889,1094,563,1342,531,1055,412,287,255,175,184,112,155,99,117,491,316,2716,685,530,323,1259,468,989,399,270,243,209,215,61,116,535,299,392,239
21131,8435,2697,4209,1571,1139,802,2439,1127,2220,1089,219,320,106,220,113,236,181,283,450,446,4226,1453,741,664,2347,1064,2037,1019,310,371,188,262,122,233,578,479,560,494
21133,18272,5619,8779,3281,2317,1711,4802,2175,4496,2115,306,524,184,449,122,375,529,661,1131,1150,9493,3113,1884,1299,4904,2198,4501,2125,403,570,251,468,152,407,1387,1213,1318,1263
21135,10923,2436,5431,1418,1451,877,3108,996,2898,950,210,283,98,198,112,213,164,216,708,559,5492,1349,1044,657,2939,944,2665,888,274,308,140,197,134,233,716,472,793,523
21137,19668,4342,9529,2454,2160,1306,5902,1748,5490,1678,412,505,251,410,161,312,288,378,1179,857,10139,2420,1731,1109,5937,1820,5568,1674,369,500,227,387,142,285,1100,842,1371,978
21139,7652,2007,3740,1111,740,531,2398,823,2236,791,162,270,141,246,21,114,163,244,439,358,3912,1157,597,476,2355,870,2124,781,231,293,157,226,74,172,473,345,487,410
21141,21655,5056,10396,2928,2689,1651,6062,1945,5404,1724,658,779,239,432,419,591,393,477,1252,942,11259,3017,2385,1526,6109,2010,5514,1833,595,755,254,442,341,586,1368,918,1397,1134
21143,7327,1382,3898,789,1085,415,1965,551,1740,534,225,167,73,135,152,136,167,172,681,341,3429,883,571,339,1812,524,1674,516,138,153,46,96,92,138,343,219,703,416
21145,53264,12672,25054,7786,7250,4959,13288,4599,12056,4237,1232,1535,573,1074,659,1130,901,1270,3615,2839,28210,7552,6130,3983,14045,4751,12641,4480,1404,1607,739,1166,665,1097,3838,2846,4197,3086
21147,14193,4110,7798,2462,2696,1526,4036,1580,3424,1445,612,599,275,433,337,378,228,325,838,670,6395,2170,1177,886,3848,1617,3500,1533,348,511,305,473,43,199,686,642,684,700
21149,7504,1462,3663,831,831,423,2410,649,2276,633,134,146,27,88,107,139,120,138,302,237,3841,823,588,361,2394,630,2263,626,131,164,86,131,45,102,410,303,449,297
21151,74989,14065,36114,8727,13204,6454,17729,4660,16537,4375,1192,1462,600,1061,592,991,828,1194,4353,2994,38875,8606,13412,6082,17413,4678,15801,4260,1612,1782,906,1275,706,1148,2878,2091,5172,3289
21153,10133,2708,5013,1625,1335,870,2867,1107,2686,1052,181,271,138,250,43,153,213,276,598,508,5120,1494,748,573,3024,1125,2551,1000,473,485,330,356,143,264,646,470,702,535
21155,15365,3036,7719,1895,2688,1155,3380,973,3112,931,268,304,73,187,195,264,261,277,1390,979,7646,1717,1892,1012,3475,1066,3251,1022,224,296,83,213,141,244,892,617,1387,835
21157,25919,5522,12537,3182,2985,1859,7552,2212,7104,2169,448,570,145,336,303,479,397,530,1603,1202,13382,3432,2335,1626,7927,2329,7405,2257,522,635,327,508,195,415,1547,1228,1573,1190
21159,9746,2949,5435,1893,1703,918,2835,1172,2328,1063,507,481,141,243,366,386,222,283,675,546,4311,1419,770,639,2723,1066,2466,1029,257,302,165,267,92,169,501,454,317,312
21161,13871,3226,6745,1897,2190,1241,3727,1196,3491,1163,236,324,132,258,104,244,215,293,613,535,7126,1870,1607,1075,3605,1175,3298,1108,307,393,131,266,176,310,829,559,1085,735
21163,22940,4397,11501,2571,3100,1577,6735,1862,6387,1815,348,418,171,321,177,325,433,519,1233,940,11439,2541,2237,1364,7115,1894,6661,1852,454,544,187,338,267,434,831,695,1256,899
21165,5350,1010,2775,598,678,327,1603,416,1532,410,71,93,52,86,19,61,151,156,343,205,2575,556,365,229,1584,407,1495,392,89,98,63,88,26,59,405,250,221,169
21167,17644,3611,8505,2071,2147,1286,4966,1419,4671,1346,295,406,151,312,144,295,323,401,1069,775,9139,2192,1915,1327,4973,1403,4697,1350,276,397,196,336,80,232,1016,706,1235,839
21169,8113,2038,4007,1225,986,654,2482,834,2388,831,94,158,59,141,35,128,117,172,422,374,4106,1092,576,392,2466,850,2327,822,139,218,36,132,103,186,522,422,542,408
21171,8622,1693,4255,1021,1044,527,2452,712,2199,689,253,263,137,203,116,176,159,179,600,383,4367,942,862,469,2247,689,2149,680,98,144,33,98,65,142,789,391,469,329
21173,22316,4880,10770,2846,3145,1770,5934,1705,5340,1626,594,652,321,466,273,409,309,420,1382,1132,11546,2830,2208,1468,6044,1780,5257,1608,787,806,385,496,402,556,1210,916,2084,1296
21175,11329,1969,6439,1279,2207,781,2921,816,2586,771,335,221,161,190,174,175,230,256,1081,509,4890,1044,722,420,2754,779,2584,743,170,217,151,215,19,123,574,375,840,528
21177,25835,7145,12671,4060,3461,2249,7143,2629,6645,2552,498,670,251,492,247,492,245,439,1822,1530,13164,4266,2571,2100,7256,2734,6575,2537,681,840,360,628,321,560,1724,1400,1613,1372
21179,36732,6029,17991,3677,5114,2427,10158,2394,9768,2347,390,519,168,358,222,424,651,705,2068,1461,18741,3566,4569,2181,9940,2326,9531,2284,409,573,155,368,254,443,1530,1086,2702,1522
21181,5736,1132,2726,634,732,390,1530,413,1420,403,110,117,63,87,47,93,55,85,409,260,3010,687,729,370,1446,424,1324,408,122,130,62,88,60,99,340,232,495,288
21183,19068,4081,9481,2439,2331,1482,5531,1636,5112,1546,419,492,209,383,210,325,286,356,1333,906,9587,2226,1936,1209,5355,1532,4858,1462,497,561,369,490,128,257,1059,727,1237,801
21185,52528,8010,27851,5016,8717,3321,15974,3119,14952,2896,1022,872,328,521,694,752,552,645,2608,1482,24677,4411,5480,2770,15366,2827,14862,2755,504,727,178,488,326,625,1571,1165,2260,1402
21187,8818,2270,4382,1306,1179,684,2338,804,2280,791,58,138,25,110,33,122,164,210,701,495,4436,1260,824,531,2475,891,2313,847,162,237,121,227,41,112,577,394,560,437
21189,3683,851,1685,477,431,287,966,345,842,330,124,122,62,100,62,89,140,147,148,136,1998,489,491,263,912,317,765,280,147,146,89,125,58,92,276,192,319,187
21191,11799,2647,5954,1531,1720,968,3157,944,3054,939,103,203,42,142,61,164,308,351,769,637,5845,1477,1243,740,3364,986,3027,918,337,371,175,262,162,244,670,489,568,420
21193,21639,6164,10524,3555,2660,1714,5939,2429,5308,2281,631,734,287,504,344,528,554,658,1371,1294,11115,3502,2362,1654,5342,2205,4698,2036,644,753,421,615,223,422,1541,1283,1870,1421
21195,49449,12863,23779,7514,5801,3905,14309,5251,13357,4976,952,1470,362,942,590,1180,1043,1456,2626,2372,25670,7169,4402,3232,14098,5030,12879,4819,1219,1682,859,1377,360,930,3867,2909,3303,2730
21197,9822,2595,4820,1576,1313,871,2679,981,2484,929,195,270,115,220,80,178,206,284,622,540,5002,1469,796,622,2872,1070,2553,948,319,388,214,301,105,194,542,411,792,570
21199,52481,11766,25352,6824,6926,3986,13555,4196,12542,4061,1013,1167,374,778,639,906,1054,1311,3817,2955,27129,6981,5774,3769,14105,4448,12745,4133,1360,1622,884,1317,476,877,3038,2188,4212,2930
21201,1678,256,837,164,209,94,447,120,379,106,68,61,22,24,46,55,14,20,167,95,841,156,191,83,430,106,388,99,42,33,16,20,26,27,84,61,136,98
21203,13797,3015,6700,1691,1831,1028,3673,1124,3472,1093,201,282,94,183,107,236,249,304,947,668,7097,1740,1332,828,4017,1202,3632,1109,385,408,232,312,153,278,773,562,975,567
21205,20645,4766,9829,2955,4118,2029,4246,1584,3772,1393,474,587,247,418,227,395,244,381,1221,1017,10816,2832,4107,1882,4370,1564,3948,1469,422,551,243,378,179,338,863,779,1476,1112
21207,14509,3477,7000,1973,1885,1103,3799,1287,3555,1230,244,372,113,267,131,278,238,323,1078,822,7509,2048,1642,1092,3666,1318,3304,1213,362,494,186,339,176,338,930,671,1271,848
21209,43069,7562,21177,4557,5788,2944,12534,3105,11895,3031,639,845,374,675,265,540,566,784,2289,1641,21892,4437,5108,2713,12452,3192,11960,3104,492,727,326,624,166,508,1416,1183,2916,1860
21211,38216,7421,18224,4347,5231,2681,10767,2820,9913,2654,854,982,333,613,521,713,437,602,1789,1501,19992,4197,4773,2375,10861,2810,9664,2565,1197,1057,583,741,614,683,1805,1323,2553,1595
21213,14500,3091,7030,1800,2070,1203,4040,1230,3681,1208,359,391,126,255,233,293,132,255,788,642,7470,1882,1623,1064,3950,1255,3502,1154,448,485,134,279,314,449,738,561,1159,792
21215,15232,2445,7701,1408,1836,823,4783,1038,4699,1021,84,155,17,106,67,145,164,224,918,567,7531,1344,1380,673,4722,1005,4525,970,197,235,132,207,65,133,505,353,924,545
21217,20775,5521,9994,3279,3081,2171,5453,2020,4950,1921,503,633,161,350,342,523,244,413,1216,1168,10781,3225,2643,1676,5508,2166,4859,1919,649,865,331,586,318,550,1329,1077,1301,1166
21219,9572,1805,4748,1086,1180,644,2925,774,2684,748,241,279,41,117,200,272,107,162,536,343,4824,1001,969,491,2685,747,2580,727,105,152,51,122,54,110,417,313,753,461
21221,11866,2404,5801,1370,1402,799,3352,1003,3209,958,143,252,110,227,33,145,275,337,772,583,6065,1406,1136,768,3420,976,3177,926,243,322,136,249,107,228,650,450,859,555
21223,7046,1574,3449,890,902,458,2018,648,1837,612,181,165,113,134,68,97,79,97,450,313,3597,896,889,479,1949,623,1779,595,170,192,100,145,70,110,336,228,423,314
21225,12349,2622,6466,1628,2519,1066,3049,928,2912,920,137,238,64,200,73,179,164,226,734,562,5883,1506,1319,796,3335,1075,3068,1012,267,320,209,295,58,168,518,378,711,482
21227,104204,21111,50670,13240,19401,9498,24303,7150,22246,6644,2057,2510,780,1510,1277,1882,1328,1902,5638,4274,53534,12786,18092,8577,24500,7061,22594,6755,1906,2241,1053,1718,853,1502,4134,3503,6808,4507
21229,9642,1797,4695,1079,1373,702,2651,711,2529,683,122,173,48,114,74,150,112,154,559,378,4947,1009,1100,519,2778,706,2629,696,149,161,77,127,72,130,505,306,564,373
21231,16975,4722,8440,2831,2560,1750,4492,1709,4095,1573,397,497,259,397,138,301,415,576,973,904,8535,2718,1808,1307,4319,1685,3925,1538,394,572,186,388,208,405,1070,916,1338,1156
21233,10541,2285,5261,1336,1576,779,2813,843,2491,799,322,303,143,231,179,220,230,243,642,451,5280,1363,1029,656,2940,875,2689,832,251,286,119,209,132,193,597,421,714,503
21235,28505,7576,13778,4259,4117,2262,7521,2863,6789,2646,732,954,383,673,349,662,485,700,1655,1444,14727,4375,3369,2236,8076,3082,7288,2840,788,1025,411,721,377,651,1223,1143,2059,1627
21237,5838,1775,2852,1047,869,630,1371,593,1154,527,217,231,190,219,27,87,56,97,556,376,2986,933,472,380,1442,671,1342,634,100,166,97,166,3,71,484,298,588,461
21239,21612,3432,9974,1954,2583,1361,6170,1336,5835,1288,335,432,138,313,197,297,291,366,930,596,11638,2081,2828,1279,6176,1325,5783,1272,393,459,117,273,276,353,1100,710,1534,917
22001,48831,14384,23450,8553,7962,5180,12464,5040,11666,4799,798,1290,443,1069,355,858,987,1370,2037,2274,25381,8282,7679,5146,12191,4860,11162,4630,1029,1478,554,1108,475,1033,2460,2179,3051,2823
22003,20835,5186,12086,3374,4604,2111,5327,1898,3773,1712,1554,646,524,506,1030,417,378,479,1777,1155,8749,2613,2083,1357,4491,1818,3991,1648,500,631,426,588,74,267,999,784,1176,917
22005,95534,19389,46477,11365,14601,7346,26836,7256,25310,6940,1526,1976,591,1155,935,1447,712,1109,4328,3567,49057,11665,13318,7317,26715,6837,24894,6566,1821,2043,1235,1716,586,1098,3738,3096,5286,3668
22007,18398,5038,8852,2909,3183,1860,4496,1721,3945,1560,551,728,144,344,407,622,359,489,814,883,9546,3014,3000,1841,4176,1620,3680,1461,496,654,182,346,314,510,962,730,1408,1141
22009,32699,8613,16339,5120,6042,3212,7534,2983,6511,2676,1023,1057,251,596,772,916,486,686,2277,1793,16360,4928,4436,2844,7889,3055,6464,2630,1425,1485,498,767,927,1200,2201,1657,1834,1693
22011,29506,6121,14959,3659,4644,2290,8118,2382,7431,2186,687,776,555,686,132,355,366,460,1831,1295,14547,3450,3204,1786,7552,2192,6665,1954,887,924,679,827,208,379,1717,1053,2074,1293
22013,11033,2697,5129,1557,1897,1004,2326,892,2139,872,187,254,98,201,89,219,245,290,661,503,5904,1731,1946,1139,2397,920,2097,862,300,333,131,252,169,271,914,644,647,521
22015,100086,23005,49020,13847,15964,8850,27030,8824,24790,8278,2240,2691,695,1541,1545,2286,1303,1920,4723,4055,51066,13291,13646,7882,26556,8338,24107,7845,2449,2861,1197,1995,1252,2001,4530,3945,6334,4722
22017,196585,55463,91570,32464,36673,23015,41022,16914,36675,15524,4347,5714,2136,4167,2211,4134,3210,4869,10665,9732,105015,33184,37828,22866,42794,17269,37004,15597,5790,6890,3155,4906,2635,4719,11160,8845,13233,10380
22019,159398,42021,76902,24743,27150,16330,38862,14475,35379,13271,3483,4870,2129,3913,1354,2875,2294,3485,8596,7657,82496,24557,23402,14684,39127,14158,34861,12995,4266,5280,2728,4123,1538,3130,8435,6813,11532,9267
22021,8008,2014,4147,1282,1481,858,2020,769,1920,753,100,167,36,131,64,150,130,199,516,397,3861,1140,895,594,1943,732,1764,672,179,242,152,229,27,129,406,335,617,464
22023,5702,1572,2811,888,894,508,1649,591,1596,592,53,124,34,123,19,112,57,141,211,233,2891,906,581,471,1690,623,1613,625,77,166,52,152,25,130,277,320,343,320
22025,7991,1979,4268,1506,1680,989,2076,717,1823,641,253,256,76,133,177,213,68,112,444,324,3723,803,896,432,2075,617,1854,609,221,211,130,167,91,145,473,310,279,236
22027,13584,3527,7907,2571,3632,1922,3079,1277,2539,1190,540,393,186,305,354,312,204,281,992,644,5677,1619,1937,1090,2522,953,2277,899,245,327,128,256,117,263,820,539,398,367
22029,15875,4466,8128,2681,3441,1839,3494,1572,2845,1386,649,624,173,333,476,528,326,446,867,702,7747,2590,2184,1544,3578,1579,2920,1413,658,697,252,408,406,548,1068,912,917,838
22031,21733,5097,10335,3072,3580,1986,5238,1764,4663,1666,575,608,311,484,264,410,313,412,1204,990,11398,2959,3199,1756,5374,1887,4661,1744,713,740,412,553,301,513,1373,973,1452,1051
22033,359116,99824,169497,59081,77765,44741,72211,28881,65084,25874,7127,10411,3058,6814,4069,7778,4595,7770,14926,14755,189619,61288,75639,43621,72351,28925,64083,25479,8268,11184,3926,7536,4342,8072,17106,14559,24523,19669
22035,5908,1598,3695,1204,2293,878,882,413,601,331,281,210,56,109,225,192,96,159,424,227,2213,747,895,537,800,397,658,347,142,187,39,119,103,164,259,205,259,233
22037,16495,3567,9230,2238,4202,1451,3690,1320,3011,1205,679,436,150,267,529,400,380,422,958,565,7265,1996,1920,1172,3711,1317,3399,1259,312,385,157,313,155,273,731,560,903,684
22039,26636,7521,13641,4479,5560,3076,6109,2584,5108,2226,1001,1137,545,869,456,677,523,750,1449,1318,12995,4239,3790,2593,6093,2572,5115,2224,978,1188,660,901,318,710,1359,1213,1753,1506
22041,15926,3812,7697,2273,2701,1463,3900,1374,3263,1218,637,611,242,382,395,471,286,372,810,716,8229,2322,2148,1290,3946,1395,3330,1244,616,608,286,407,330,466,1222,823,913,757
22043,18507,4119,10668,2672,4190,1698,4575,1585,3744,1424,831,489,497,424,334,300,235,361,1668,991,7839,2193,2283,1269,3997,1417,3512,1329,485,510,336,442,149,262,716,590,843,669
22045,56125,14974,27288,8667,10397,6009,13238,5099,12213,4753,1025,1500,477,1084,548,1142,784,1198,2869,2618,28837,8934,9508,6035,13648,5216,12131,4711,1517,1915,860,1427,657,1322,2795,2319,2886,2435
22047,27073,6463,13555,3863,5947,2667,5645,2252,4548,1858,1097,946,344,536,753,780,357,509,1606,1130,13518,4005,4388,2443,5593,2315,4643,1926,950,1080,331,608,619,801,1603,1232,1934,1486
22049,12985,2502,6583,1635,2386,1056,3205,934,2877,892,328,281,158,236,170,212,209,278,783,561,6402,1472,1594,822,3270,968,2929,895,341,397,217,301,124,271,846,494,692,484
22051,354246,85034,169555,51616,62513,35346,83449,30586,75007,27903,8442,11093,3223,6866,5219,8783,5054,7495,18539,16077,184691,50732,59967,32622,80987,28688,72492,26397,8495,10373,4469,7797,4026,7382,19059,14760,24678,17737
22053,24840,5883,12092,3444,4003,2328,6273,2143,5828,2025,445,674,187,476,258,540,663,768,1153,1125,12748,3468,3260,2044,6213,2120,5745,1992,468,680,319,583,149,438,1544,1110,1731,1357
22055,193718,44680,93491,27551,37751,20243,44017,14846,41486,14165,2531,3756,1174,2771,1357,2729,2565,3815,9158,8138,100227,26076,33753,17737,45232,14794,41343,13917,3889,4812,1991,3428,1898,3332,7708,6865,13534,9981
22057,78838,17610,38483,10450,12465,6977,21364,6454,19877,6141,1487,1840,612,1301,875,1439,1173,1636,3481,3253,40355,10247,11096,6144,20585,6260,18826,5803,1759,2295,1054,1786,705,1448,3998,3113,4676,3627
22059,12118,3579,6385,1989,2222,1185,3252,1220,2747,1151,505,491,169,284,336,426,250,366,661,568,5733,2118,1344,1053,2963,1205,2492,1052,471,528,157,325,314,429,604,516,822,764
22061,39383,10384,18950,6350,9742,5208,7552,2706,6773,2475,779,1068,300,649,479,829,372,621,1284,1248,20433,6724,9444,5443,7389,2605,6501,2380,888,1066,522,820,366,711,1761,1346,1839,1518
22063,109054,26393,52935,15217,16073,9205,28395,9021,26005,8589,2390,2849,1298,2034,1092,1807,1832,2378,6635,5364,56119,15118,13460,8011,29255,9465,26573,8807,2682,3262,1966,2711,716,1470,5214,4011,8190,5914
22065,9016,1698,4491,1120,2346,861,1565,561,1148,443,417,320,125,205,292,258,102,173,478,272,4525,1081,2071,773,1550,551,1182,445,368,306,170,182,198,229,458,290,446,326
22067,20410,5406,9637,3098,3812,2135,4534,1826,4083,1698,451,628,217,441,234,488,331,493,960,875,10773,3357,3733,2335,4907,2000,4294,1756,613,792,461,676,152,414,1174,939,959,912
22069,31021,7935,14497,4808,7325,3838,5593,2150,5096,2033,497,714,258,573,239,561,547,755,1032,1086,16524,5091,7804,4139,6239,2394,5508,2189,731,874,566,814,165,476,1328,1102,1153,976
22071,324511,88617,151960,54338,78338,41965,51775,24021,42336,19854,9439,12577,3918,9010,5521,9958,4101,8498,17746,16796,172551,55355,81376,41049,52478,23819,42529,19928,9949,12433,5001,9309,4948,9534,14921,13765,23776,18364
22073,123139,32201,58167,19089,24216,13435,26147,9874,22894,8731,3253,3856,1487,2524,1766,2907,1850,2856,5954,5390,64972,19260,22547,12786,27764,10440,23929,9059,3835,4608,2292,3498,1543,2741,6459,5287,8202,6314
22075,18217,5046,9029,2976,2657,1724,5210,2033,4658,1866,552,736,174,465,378,581,281,470,881,864,9188,2952,2187,1657,4888,1890,4410,1810,478,676,303,583,175,401,857,791,1256,1056
22077,17969,4353,8444,2457,3091,1695,3984,1404,3699,1322,285,434,77,248,208,393,354,461,1015,848,9525,2625,2863,1505,4230,1528,3716,1362,514,579,357,500,157,332,1276,889,1156,836
22079,104006,27119,49512,16063,18723,11046,23227,8578,20528,7862,2699,3266,1190,2232,1509,2432,1760,2448,5802,4906,54494,15861,15719,9546,24625,9041,21018,7973,3607,4095,2113,2941,1494,2519,6247,4797,7903,5766
22081,6769,1851,3204,1096,1048,652,1551,670,1408,638,143,198,47,128,96,169,169,196,436,383,3565,1090,1187,622,1599,667,1418,618,181,243,146,207,35,114,444,347,335,334
22083,16440,3980,7871,2457,2900,1720,3664,1332,3135,1180,529,627,254,428,275,428,292,368,1015,784,8569,2333,2609,1412,3756,1420,3129,1145,627,681,393,541,234,390,1065,706,1139,870
22085,19301,4245,9463,2376,2915,1408,4958,1550,4537,1469,421,483,221,387,200,358,426,429,1164,823,9838,2521,2681,1553,4873,1526,4449,1470,424,445,217,342,207,350,1146,781,1138,795
22087,35658,9482,17223,5696,7013,3834,7764,3164,6900,2754,864,1273,561,1025,303,877,541,964,1905,1829,18435,5641,6552,3749,7487,3005,6390,2545,1097,1438,671,1143,426,969,1554,1445,2842,2112
22089,42170,9478,20573,5379,6986,3620,11361,3346,10387,3216,974,1126,568,880,406,738,493,766,1733,1522,21597,5637,6064,3499,11287,3464,10515,3278,772,1070,451,784,321,710,1494,1408,2752,1950
22091,8471,2817,3991,1767,1388,1004,2073,1070,1856,997,217,270,152,236,65,153,81,173,449,393,4480,1582,1397,981,2194,1039,1983,993,211,289,91,190,120,215,512,471,377,327
22093,17327,3710,8078,2238,2819,1489,4211,1340,3928,1226,283,462,203,412,80,267,247,371,801,765,9249,2341,2953,1610,4553,1352,3974,1248,579,625,283,438,296,443,790,628,953,709
22095,34393,9287,16672,5389,6523,3645,8273,3244,7034,2906,1239,1421,489,761,750,1134,473,753,1403,1275,17721,5537,6069,3659,7979,3174,7300,3009,679,958,415,773,264,595,1667,1415,2006,1694
22097,64514,17870,30525,10267,11621,6873,15019,6074,13561,5587,1458,2109,929,1700,529,1259,1286,1820,2599,2505,33989,10559,11111,6627,15121,5995,13640,5531,1481,1960,853,1468,628,1340,3796,2952,3961,3209
22099,42839,10499,20962,6061,7790,4145,10871,3701,10039,3512,832,1086,316,697,516,820,576,806,1725,1602,21877,6116,6731,3861,10578,3595,9815,3382,763,1025,360,727,403,732,2001,1572,2567,2132
22101,40672,10730,19825,6291,8567,4542,8772,3697,7821,3369,951,1313,523,992,428,904,717,1087,1769,1660,20847,6572,8266,4593,8246,3376,7373,3109,873,1168,479,907,394,863,2120,1734,2215,1906
22103,204856,43138,98373,25104,30653,16148,54254,15009,51231,14299,3023,4031,1289,2739,1734,3041,3546,4430,9920,7758,106483,25653,27329,15048,54319,14952,50395,14061,3924,4908,2029,3395,1895,3319,9779,7401,15056,9615
22105,104695,27629,50125,16127,18534,10630,24100,9369,22196,8887,1904,2603,991,1821,913,1727,1199,1849,6292,5459,54570,16371,18215,10222,24353,9407,21551,8623,2802,3219,1558,2349,1244,1900,5599,4416,6403,5091
22107,3665,880,1758,506,719,349,767,288,647,260,120,135,65,105,55,90,61,102,211,158,1907,523,675,366,806,295,717,284,89,109,31,81,58,101,263,170,163,127
22109,88023,24762,43028,14565,15302,9437,21472,8544,19278,7483,2194,3162,639,1647,1555,2663,1255,2066,4999,4623,44995,14298,13233,8682,21353,8071,18964,7247,2389,3109,1317,2279,1072,2064,4433,3852,5976,4981
22111,18320,5076,9063,3087,3298,1973,4282,1568,3935,1476,347,414,124,288,223,375,660,800,823,739,9257,2965,2775,1802,4166,1556,3853,1471,313,452,83,243,230,430,1141,895,1175,1015
22113,47229,12335,22492,6616,6601,3919,12698,4552,11852,4263,846,1258,506,1065,340,826,764,1098,2429,2208,24737,7356,6564,4245,12015,4297,11052,3987,963,1322,580,1002,383,890,2678,2203,3480,2623
22115,38928,8781,20875,5885,6876,3738,11400,3393,10264,3120,1136,1262,454,782,682,950,522,756,2077,1449,18053,4223,3983,2201,10491,2861,9336,2685,1155,1081,527,755,628,786,1445,1085,2134,1442
22117,37270,9633,18195,5526,6414,3643,8564,3280,7543,3049,1021,1212,624,984,397,651,913,1078,2304,1699,19075,5713,5536,3427,8461,3307,7538,3054,923,1105,593,875,330,641,2288,1736,2790,2243
22119,31877,8475,15359,5133,5643,3419,7460,3012,7097,2964,363,660,162,508,201,577,711,900,1545,1361,16518,4986,5032,3270,7348,2946,6794,2788,554,900,311,702,243,649,2101,1651,2037,1598
22121,20894,4167,10229,2602,3718,1922,5327,1535,4850,1487,477,479,192,312,285,349,310,399,874,721,10665,2421,3586,1740,5464,1614,5168,1570,296,434,97,252,199,368,610,543,1005,779
22123,8914,2074,4464,1247,1380,710,2288,809,1963,761,325,340,63,154,262,320,183,221,613,543,4450,1235,1000,619,2169,796,1911,745,258,288,100,176,158,253,645,399,636,406
22125,13377,3029,8785,2015,4107,1438,2844,933,2142,724,702,402,98,118,604,391,398,323,1436,820,4592,1521,1635,1099,1782,611,1661,597,121,151,79,119,42,120,578,442,597,417
22127,11908,3109,6451,1802,2286,1011,3131,1219,2786,1152,345,360,154,306,191,274,263,368,771,552,5457,1796,1297,923,2652,1074,2481,1048,171,301,120,285,51,210,875,658,633,553
23001,87983,16522,42621,9827,14419,6799,21534,6481,20676,6256,858,1473,294,1019,564,1187,1226,1630,5442,3876,45362,9919,11560,6191,22560,6677,21342,6445,1218,1637,545,1187,673,1202,4208,3014,7034,4479
23003,57668,11669,28300,6878,8149,4301,15697,4442,14858,4297,839,1136,245,829,594,1024,988,1218,3466,2448,29368,6768,6300,3678,15716,4508,14936,4330,780,1167,283,879,497,1006,3775,2359,3577,2445
23005,247230,49950,118680,30331,41050,21229,61589,18305,58348,17492,3241,4935,853,2864,2388,4226,2788,4271,13253,10361,128550,29592,37290,18969,62438,18535,59536,17875,2902,4585,944,2882,1958,3909,10701,8662,18121,11955
23007,25587,5408,12468,3094,3601,1810,6612,1925,6248,1847,364,465,58,283,306,425,428,529,1827,1263,13119,3070,3384,1570,6492,1919,6051,1782,441,648,85,316,356,591,1270,947,1973,1209
23009,46809,8710,22499,5021,6036,2898,12837,3476,12196,3363,641,865,240,594,401,726,504,700,3122,2014,24310,5186,5078,2780,12987,3562,12276,3402,711,1049,267,667,444,838,2444,1684,3801,2136
23011,102429,21373,49455,12412,15405,8160,24964,7955,23835,7696,1129,1823,310,1289,819,1585,1654,2146,7432,5343,52974,12782,13260,7704,25940,8182,24656,7857,1284,2080,573,1564,711,1535,4522,3668,9252,6025
23013,33893,6969,16700,4135,4943,2684,8919,2791,8378,2695,541,704,242,625,299,513,516,705,2322,1548,17193,4140,3715,2476,9009,2782,8556,2705,453,742,174,545,279,621,1796,1299,2673,1796
23015,29552,5404,14308,3078,3854,1920,8368,2202,8023,2133,345,513,104,362,241,441,422,540,1664,1145,15244,3183,2766,1591,8206,2125,7734,2021,472,617,235,519,237,432,1818,1155,2454,1306
23017,48889,9888,23919,5823,7383,3740,12058,3488,11437,3373,621,835,282,641,339,647,832,921,3646,2316,24970,5917,6121,3287,12205,3581,11329,3355,876,1028,444,795,432,705,2834,1986,3810,2320
23019,129234,24388,63530,15150,22457,10893,31469,8953,29614,8587,1855,2506,748,1768,1107,1963,1848,2286,7756,5551,65704,14654,18682,9434,31095,8852,29174,8475,1921,2485,856,1741,1065,1924,6470,4686,9457,6076
23021,14559,2597,7306,1557,2013,939,3713,941,3574,928,139,225,48,196,91,211,236,260,1344,711,7253,1506,1458,788,3661,953,3456,912,205,295,129,247,76,228,880,484,1254,673
23023,29943,5246,14509,3238,3517,1981,8682,2260,8306,2164,376,608,129,399,247,496,455,641,1855,1430,15434,3065,3365,1899,8459,2208,8167,2153,292,485,127,371,165,395,1295,970,2315,1417
23025,42622,8814,21023,5277,6226,3237,10914,3386,10383,3302,531,775,173,538,358,678,953,1087,2930,1934,21599,4995,4868,2713,10849,3313,10277,3256,572,807,263,596,309,622,2130,1570,3752,2243
23027,33476,5632,16244,3164,4429,1901,9318,2298,8969,2275,349,445,117,306,232,417,435,478,2062,1187,17232,3331,3802,1818,9094,2252,8656,2184,438,621,268,521,170,397,1653,1060,2683,1355
23029,26575,3994,12975,2290,3868,1533,6768,1494,6382,1405,386,456,154,336,232,391,543,509,1796,911,13600,2422,2966,1375,6644,1441,6195,1364,449,456,135,316,314,425,1654,853,2336,1104
23031,172777,36024,83281,21301,23916,13185,46793,13766,44589,13274,2204,3346,907,2255,1297,2567,2582,3421,9990,7745,89496,21025,21481,12375,47518,14185,45020,13565,2498,3619,1053,2385,1445,2714,8250,6645,12247,8223
24001,61267,11023,31965,7005,13260,5160,13743,3833,12074,3499,1669,1311,645,967,1024,1008,1111,1181,3851,2433,29302,6357,7958,3882,13710,3916,12582,3660,1128,1322,674,1066,454,865,3451,2055,4183,2466
24003,464554,93630,228305,56288,77791,37592,125020,34206,116029,31789,8991,10600,3888,7022,5103,7901,5100,7512,20394,16171,236249,53966,64691,33608,124837,33579,115516,31662,9321,10677,4559,7561,4762,7516,18379,14251,28342,18946
24005,679321,134503,316888,79638,116030,56047,164739,48603,149132,44295,15607,18186,6198,11281,9409,13850,8922,12011,27197,22811,362433,82708,116519,55356,164594,47839,146840,43712,17754,18636,8193,12410,9561,13970,37398,25133,43922,28877
24009,74473,13058,36692,7835,11473,5201,20710,4842,19564,4655,1146,1481,601,1076,545,964,992,1224,3517,2730,37781,7525,9667,4734,20619,4791,19450,4675,1169,1412,667,1083,502,932,2997,2142,4498,3054
24011,26554,4925,12871,3041,4449,2140,6623,1728,6202,1598,421,524,186,347,235,397,501,557,1298,919,13683,2675,3793,1633,6896,1722,6479,1668,417,476,196,353,221,359,1416,880,1578,985
24013,138245,23455,67837,13523,19621,8961,40302,8902,38784,8611,1518,2295,697,1784,821,1751,2161,2591,5753,4402,70408,13939,16121,8243,41071,8982,38956,8604,2115,2658,1074,1916,1041,1984,6138,4300,7078,4650
24015,83526,17790,41123,10427,13245,6638,21730,6139,20164,5803,1566,1917,512,1090,1054,1544,1386,1709,4762,3709,42403,10595,11207,6368,21975,6100,20192,5819,1783,1993,951,1386,832,1382,3984,3225,5237,3666
24017,128136,24737,60870,14075,21885,9948,32695,8438,30194,8088,2501,2620,881,1566,1620,2144,1363,1875,4927,4146,67266,14844,21850,9510,32858,8497,29997,7906,2861,3027,1323,2184,1538,2060,4689,3660,7869,4859
24019,26500,6007,12363,3554,4102,2326,6415,2070,5805,1971,610,690,199,470,411,590,390,556,1456,1133,14137,3561,3805,2016,6578,2166,5818,1987,760,802,327,558,433,647,1732,1161,2022,1316
24021,203412,37796,99343,22569,30594,14801,58179,14483,54321,13744,3858,4775,1391,3086,2467,4020,2470,3643,8100,6997,104069,22012,27636,13833,56297,14099,52953,13416,3344,4408,1529,3237,1815,3486,8215,6499,11921,7921
24023,24812,4666,12240,2732,3342,1667,7117,1872,6704,1785,413,485,226,385,187,359,579,597,1202,906,12572,2643,2755,1386,7074,1824,6693,1780,381,470,199,398,182,331,1397,875,1346,941
24025,206203,38609,99982,23156,30304,15532,59429,14552,55989,13913,3440,4423,1668,3234,1772,3231,2257,3366,7992,6744,106221,22290,27949,14368,57646,13828,54371,13358,3275,4283,1857,3404,1418,2950,9586,7046,11040,7559
24027,255361,45031,123402,26444,38920,18076,74863,16939,70591,15976,4272,5137,1376,3083,2896,4163,2595,3683,7024,6432,131959,26825,36332,17721,74582,16495,69044,15460,5538,5769,2171,3559,3367,4507,8540,7023,12505,8434
24029,16991,3729,8004,2158,2668,1351,4329,1422,3920,1343,409,495,144,326,265,399,325,440,682,631,8987,2337,2750,1342,4220,1466,3936,1412,284,396,167,327,117,280,1038,739,979,730
24031,841529,162603,400763,97103,134787,66410,233009,59412,211708,54060,21301,22834,4965,11236,16336,19880,7077,11591,25890,23881,440766,95654,132177,62737,231012,58233,206950,52391,24062,23699,8284,13468,15778,19036,32695,24983,44882,30802
24033,737565,151086,350323,93130,155461,66921,158495,50913,133531,44006,24964,23605,8609,12977,16355,18847,7197,11029,29170,24596,387242,90205,155149,62840,154153,48653,127321,41643,26832,23898,10994,14441,15838,17630,30040,22864,47900,30113
24035,40849,6654,20118,3986,5515,2654,12106,2536,11348,2410,758,832,345,598,413,586,561,690,1936,1287,20731,3812,4652,2389,11832,2485,11212,2425,620,712,352,520,268,516,1854,1195,2393,1431
24037,89645,18054,44719,10670,15168,7032,24750,6743,22986,6339,1764,2184,815,1430,949,1523,1212,1651,3589,2916,44926,10296,13037,6387,23713,6304,22021,5965,1692,1985,728,1305,964,1490,3108,2603,5068,3541
24039,21988,4583,11960,2968,6097,2012,4188,1492,3325,1261,863,623,261,412,602,513,355,419,1320,754,10028,2430,3809,1561,3981,1436,3759,1391,222,382,67,261,155,343,1064,800,1174,845
24041,31594,5397,14839,3297,3715,2162,9268,2280,8678,2184,590,681,220,435,370,545,569,631,1287,1017,16755,3130,3453,1851,9361,2261,8923,2222,438,577,240,477,198,427,1790,1080,2151,1309
24043,123090,23499,62550,14527,22940,10055,30984,8552,28038,7867,2946,2785,957,1732,1989,2255,1737,2144,6889,4793,60540,13333,15645,8083,31156,8534,28403,7937,2753,3056,1409,2247,1344,2061,6198,4141,7541,4940
24045,83923,20739,39215,12159,16186,8605,18335,6594,16552,6135,1783,2212,962,1673,821,1451,1014,1628,3680,3091,44708,12494,16889,8750,17853,6340,16049,5906,1804,2255,1185,1874,619,1312,4274,3325,5692,3907
24047,44399,9554,21508,5793,6406,3736,11986,3557,11088,3404,898,1163,267,737,631,996,831,1051,2285,1853,22891,5527,5007,3087,12093,3572,11075,3398,1018,1315,382,839,636,1088,3098,2068,2693,1986
24510,501978,151920,231643,89210,127254,69520,74626,39861,59976,33165,14650,18985,7103,13550,7547,13798,6486,12408,23277,23711,270335,94156,136079,71166,75903,39773,59032,32755,16871,20002,9294,14934,7577,13579,25490,22913,32863,27470
25001,187331,45200,88798,26011,26425,16546,51262,16730,48501,16166,2761,4328,761,2990,2000,3712,3150,4203,7961,7160,98533,26068,21721,13855,51610,16749,48614,16173,2996,4370,1022,3120,1974,3630,11402,8360,13800,9617
25003,109039,26377,52295,15794,18850,10711,25809,9251,23892,8739,1917,2976,925,2369,992,2280,1652,2579,5984,5196,56744,15487,17179,9835,25507,9213,23739,8722,1768,2792,822,2136,946,2262,5974,4869,8084,5629
25005,465643,98583,223033,59461,83590,41335,112119,35297,104441,33486,7678,10643,3043,7225,4635,8262,6501,9564,20823,17996,242610,58173,75752,37902,113414,35299,103167,32898,10247,12416,5672,9354,4575,8177,23320,17618,30124,21628
25007,14700,5122,7229,2908,2620,1992,3690,1759,3332,1618,358,584,40,282,318,568,198,430,721,857,7471,3057,2209,1885,3577,1719,3231,1568,346,590,99,345,247,495,622,814,1063,988
25009,646136,143455,307257,84992,113056,57412,160102,50249,147858,46897,12244,15767,4324,9981,7920,13058,7461,11768,26638,24043,338879,83938,106757,55047,162336,49994,146548,45865,15788,17739,7352,12257,8436,13128,30029,23014,39757,28411
25011,60507,10506,29221,6682,10097,4679,14790,3969,13798,3748,992,1277,404,869,588,1026,1008,1214,3326,2418,31286,6178,8679,4170,14931,3977,13700,3639,1231,1447,567,1006,664,1113,3197,2099,4479,2575
25013,384858,88717,183366,54114,78860,39456,81561,28672,74642,26395,6919,9524,3123,6677,3796,7136,5160,7424,17785,15315,201492,52035,73680,35869,83621,28820,74169,25995,9452,10942,4960,7775,4492,7727,18730,14442,25461,17980
25015,141973,25937,65487,16079,30254,12763,28165,8315,26112,7778,2053,2916,592,1652,1461,2501,1680,2271,5388,4293,76486,16511,33524,12424,29176,8491,27033,7981,2143,2787,902,1946,1241,2169,5249,4139,8537,5345
25017,1337654,280443,648975,169857,249529,121631,342689,101309,319137,94878,23552,31483,5345,17942,18207,27783,13768,23475,42989,42082,688679,166456,230141,113744,344409,101140,318270,94306,26139,33446,9565,21311,16574,27077,51115,43910,63014,50427
25019,9198,2581,4750,1734,1953,1262,2230,860,1831,681,399,487,87,207,312,413,76,189,491,403,4448,1294,1368,829,2222,773,1942,683,280,356,84,208,196,294,289,249,569,414
25021,579898,120498,275371,71529,94120,48958,157385,44874,147844,42660,9541,12728,3051,8353,6490,10375,6335,9979,17531,17341,304527,70802,93211,46454,156441,43981,145271,41726,11170,14139,4438,9442,6732,10888,25470,19957,29405,22770
25023,424911,99008,203963,57324,70001,38145,111358,34362,104396,32299,6962,9753,2196,6148,4766,8186,5822,8587,16782,15620,220948,57798,64990,36081,112032,34074,102947,31605,9085,11474,4315,7887,4770,8259,19881,15693,24045,18277
25025,684450,174894,328035,109625,183338,86000,116745,53972,95100,45998,21645,24670,7165,14062,14480,19476,5679,12253,22273,24139,356415,105816,185173,81220,117995,52943,94345,45344,23650,24876,11010,16180,12640,18090,22649,22577,30598,27680
25027,681693,146445,333249,87491,124881,60215,168592,51433,156270,48279,12322,15745,4848,10543,7474,12273,8742,12908,31034,26197,348444,85376,107412,54824,168258,51200,154720,47735,13538,17043,6933,12430,6605,12040,30024,24128,42750,30590
26001,9275,1022,4693,626,1019,354,2625,432,2488,420,137,140,30,76,107,125,251,164,798,315,4582,581,679,273,2737,438,2552,424,185,153,51,96,134,135,649,245,517,243
26003,8023,1264,4489,891,1739,564,1928,445,1657,401,271,165,87,130,184,132,199,190,623,368,3534,636,756,371,1805,429,1730,405,75,109,42,90,33,81,464,247,509,275
26005,92906,15755,46152,9527,13077,6479,27397,6149,26273,6016,1124,1473,351,973,773,1256,1003,1360,4675,3185,46754,9021,10468,5306,27350,6138,26199,5974,1151,1502,444,1017,707,1237,3533,2727,5403,3421
26007,24194,4563,11873,2756,3249,1620,6181,1722,5768,1632,413,538,160,412,253,421,525,575,1918,1207,12321,2669,2593,1473,6290,1754,6018,1697,272,501,105,416,167,412,1524,893,1914,1215
26009,19855,3100,9816,1780,2446,1037,5995,1195,5766,1179,229,255,51,208,178,233,296,289,1079,584,10039,1732,1720,847,6258,1242,5969,1215,289,336,97,238,192,271,1010,577,1051,621
26011,12875,1657,6511,1010,1816,632,3451,655,3296,629,155,186,55,144,100,167,296,242,948,433,6364,943,1231,526,3510,621,3351,610,159,165,54,141,105,152,810,375,813,386
26013,7214,850,4050,636,1836,504,1682,356,1453,315,229,164,115,131,114,99,90,95,442,224,3164,465,727,267,1643,339,1536,325,107,114,36,72,71,106,346,171,448,192
26015,49576,8773,24875,5232,6368,3423,14976,3663,14399,3521,577,872,142,549,435,748,672,831,2859,2035,24701,5052,4567,2684,15019,3657,14308,3523,711,904,295,615,416,707,2171,1616,2944,2017
26017,86802,17428,42249,10543,13918,7255,21109,6307,20191,6130,918,1599,397,1233,521,1275,1482,1930,5740,4222,44553,10320,11204,6142,22177,6697,20981,6435,1196,1796,563,1356,633,1375,4931,3527,6241,4285
26019,14977,1974,7361,1137,2012,760,4140,712,3952,695,188,208,54,149,134,194,301,254,908,462,7616,1203,1496,631,4202,782,3950,729,252,231,44,132,208,215,896,426,1022,498
26021,126247,24949,61204,14640,19551,10156,32570,9119,30238,8608,2332,2684,510,1684,1822,2373,2126,2645,6957,5044,65043,15028,17980,9772,32157,9036,29774,8558,2383,2846,997,2016,1386,2264,6230,4392,8676,5789
26023,35207,6144,18306,3769,5372,2249,9629,2396,8740,2192,889,799,278,567,611,692,672,698,2633,1407,16901,3352,3554,1891,9363,2330,8705,2154,658,773,311,538,347,617,1725,960,2259,1240
26025,108772,21346,52652,12830,18633,9048,25336,7639,23727,7229,1609,2200,679,1602,930,1776,1797,2098,6886,4651,56120,12890,16174,8464,26015,7718,24006,7326,2009,2528,1002,1877,1007,1809,5312,3760,8619,5305
26027,42784,7818,21281,4491,5774,2778,11971,3056,11445,2970,526,840,152,523,374,740,787,915,2749,1797,21503,4597,4632,2536,12069,2975,11335,2882,734,839,404,672,330,621,1917,1431,2885,1866
26029,22108,2699,10938,1598,2852,1116,6563,1137,6346,1102,217,269,43,224,174,254,297,290,1226,615,11170,1688,2374,1000,6294,1078,6016,1049,278,295,45,216,233,271,1045,606,1457,746
26031,22023,3466,10930,2058,2866,1238,6254,1385,5989,1359,265,334,52,249,213,307,459,400,1351,757,11093,1987,2079,1024,6419,1439,6055,1383,364,402,99,276,265,356,1155,670,1440,762
26033,31967,6104,17591,4199,7058,2920,7494,2110,6673,1810,821,801,194,424,627,759,573,606,2466,1367,14376,3217,4223,2199,6702,1786,6250,1670,452,596,249,530,203,422,1458,1019,1993,1116
26035,25651,4519,12728,2648,3535,1619,6701,1608,6332,1512,369,465,56,252,313,450,529,519,1963,1043,12923,2565,2742,1403,6761,1553,6249,1460,512,543,225,373,287,405,1731,992,1689,896
26037,64008,9267,31455,5720,10004,4278,18078,3500,17293,3352,785,1010,319,718,466,787,967,1056,2406,1698,32553,5678,8805,3944,17951,3537,17159,3314,792,1114,389,854,403,783,2625,1682,3172,1956
26039,11867,1805,6017,1069,1550,619,3478,796,3276,768,202,195,43,120,159,178,162,168,827,406,5850,1003,1144,513,3314,758,3220,740,94,172,33,126,61,148,630,329,762,412
26041,30181,4517,14874,2670,4172,1814,8498,1877,8168,1844,330,453,153,389,177,330,507,566,1697,1098,15307,2659,2897,1510,8678,1930,8239,1847,439,546,183,422,256,419,1598,973,2134,1222
26043,21363,3392,10642,2141,2962,1370,5975,1448,5815,1422,160,275,78,239,82,212,406,434,1299,907,10721,1991,2262,1179,5882,1395,5503,1328,379,478,121,252,258,399,1157,760,1420,861
26045,90683,15362,44102,9212,14072,6265,23620,5805,22564,5575,1056,1527,386,1026,670,1283,1107,1440,5303,3372,46581,9351,12096,5793,24303,6024,23099,5761,1204,1688,595,1248,609,1222,3943,2808,6239,3719
26047,27958,4091,13636,2527,4124,1709,7730,1633,7378,1574,352,409,85,259,267,345,297,335,1485,921,14322,2388,3278,1366,7510,1626,7129,1546,381,461,148,341,233,372,1504,916,2030,1019
26049,331786,72379,157749,42609,57747,30495,76822,24773,71849,23429,4973,7495,2582,5814,2391,5579,4653,6958,18527,14673,174037,44227,54282,29362,77800,25263,72328,23838,5472,7861,2908,6169,2564,5546,16252,12763,25703,17302
26051,21345,2863,10666,1665,2632,1001,6046,1133,5709,1075,337,335,105,239,232,280,452,342,1536,688,10679,1693,1868,851,6132,1161,5867,1104,265,308,125,245,140,263,1312,652,1367,705
26053,13119,2767,6986,1685,2704,1186,2992,997,2738,932,254,323,74,252,180,308,293,369,997,646,6133,1591,1446,907,3139,1024,2922,981,217,331,53,253,164,309,808,543,740,584
26055,76740,13179,37466,8000,11715,5657,20776,5031,19948,4847,828,1251,330,867,498,973,982,1274,3993,2761,39274,7766,10058,5032,20610,5003,19620,4778,990,1326,470,953,520,961,2909,2148,5697,3479
26057,34302,5135,18548,3147,7385,2144,8491,2079,7445,1853,1046,777,321,538,725,592,536,513,2136,1055,15754,2931,4101,1758,7692,1895,7331,1826,361,522,145,373,216,458,1684,963,2277,1199
26059,37549,5683,18647,3287,5587,2051,10210,2232,9730,2145,480,592,188,443,292,496,490,543,2360,1262,18902,3428,4353,1806,10206,2204,9693,2124,513,616,267,494,246,471,1963,1138,2380,1346
26061,30040,5547,16348,3835,8194,3232,6374,1706,6111,1659,263,424,82,354,181,394,469,569,1311,956,13692,3092,4555,2176,6476,1787,6102,1679,374,575,169,485,205,433,1278,907,1383,927
26063,26391,3522,13039,2082,3615,1334,7442,1368,7138,1331,304,370,111,315,193,354,495,440,1487,802,13352,2137,2557,1166,7305,1341,7057,1321,248,350,97,330,151,340,1858,954,1632,838
26065,242609,50165,117130,31457,56574,24503,46603,15297,43555,14351,3048,4697,948,3119,2100,3980,2388,4018,11565,9534,125479,31001,51630,22793,48560,15728,44873,14747,3687,5179,1301,3350,2386,4272,8576,7338,16713,11144
26067,52096,8691,28068,5562,10137,3798,13432,3096,12392,2893,1040,917,297,578,743,762,731,785,3768,2195,24028,4679,5543,2828,13189,3000,12465,2876,724,921,360,687,364,656,2048,1392,3248,2043
26069,21793,3596,10842,2109,2612,1253,6020,1474,5636,1430,384,404,207,343,177,299,539,466,1671,903,10951,2032,1945,950,5964,1504,5627,1450,337,407,135,286,202,349,1432,756,1610,830
26071,9693,1195,4824,723,1314,456,2536,477,2362,454,174,152,48,90,126,119,169,156,805,326,4869,717,902,374,2467,465,2336,450,131,136,20,77,111,132,824,351,676,332
26073,60507,8271,29254,5632,15101,4794,11207,2345,10468,2194,739,798,207,484,532,698,509,601,2437,1455,31253,5335,15149,4206,10981,2323,10266,2210,715,777,241,503,474,663,2037,1094,3086,1616
26075,130403,25730,66484,15600,23002,10363,32136,9823,28972,9039,3164,3236,996,2084,2168,2494,1864,2496,9482,5939,63919,15140,17044,9061,31322,9468,29714,9097,1608,2447,692,1756,916,1959,5912,4603,9641,6305
26077,215268,44338,104356,27728,42780,21266,49329,13622,46444,12877,2885,4059,1225,2884,1660,3061,2296,3273,9951,7870,110912,26614,40248,19862,49634,13717,46808,12961,2826,4097,1164,2825,1662,3209,8188,6650,12842,8310
26079,14542,2095,7399,1273,2080,839,4056,805,3878,778,178,205,48,156,130,184,240,208,1023,455,7143,1141,1464,643,4059,818,3797,765,262,234,97,185,165,181,676,369,944,476
26081,516492,97104,251784,60080,92823,44288,130438,33908,124055,32407,6383,8995,2276,5930,4107,7286,5179,7861,23344,18802,264708,57765,85119,40578,130112,33833,122773,31939,7339,9950,2980,6552,4359,7619,19178,15398,30299,20437
26083,1864,130,969,88,174,90,626,117,610,118,16,35,6,28,10,31,52,46,117,53,895,80,167,63,575,117,550,119,25,42,3,34,22,41,91,53,62,55
26085,10255,1382,5220,816,1458,513,2619,476,2408,434,211,170,62,133,149,139,288,205,855,315,5035,829,1153,478,2601,490,2403,446,198,173,100,135,98,140,625,278,656,300
26087,73403,11573,37299,7029,11201,4819,21270,4661,20088,4430,1182,1426,451,974,731,1108,892,1085,3936,2566,36104,6637,8091,3954,20823,4551,19930,4412,893,1170,391,852,502,928,3094,2107,4096,2554
26089,18800,2333,9251,1411,2260,879,5690,967,5466,941,224,265,55,189,169,235,313,270,988,556,9549,1312,1689,724,5830,967,5547,950,283,284,77,195,206,236,909,515,1121,531
26091,81423,14468,40969,8713,13876,5928,20628,5345,19132,5032,1496,1604,451,1016,1045,1343,1298,1477,5167,3300,40454,8482,10653,5332,20932,5396,19910,5220,1022,1370,503,1117,519,1070,3665,2529,5204,3186
26093,157020,19602,78345,12545,22671,9066,46249,7882,44630,7675,1619,2133,411,1388,1208,1881,2071,2371,7354,4699,78675,11738,17958,7938,45978,7775,44702,7649,1276,1877,385,1332,891,1657,6257,3874,8482,4787
26095,5483,811,3324,629,1336,438,1470,340,1274,284,196,145,53,96,143,131,159,166,359,188,2159,345,363,191,1162,244,1108,231,54,92,12,80,42,88,339,177,295,180
26097,9451,1563,4814,886,1366,561,2689,618,2556,583,133,195,20,130,113,183,186,177,573,333,4637,1019,926,628,2634,650,2400,583,234,255,58,150,176,221,405,275,672,369
26099,719594,136848,346538,81548,124112,57674,179248,48564,169359,46572,9889,13694,3334,8974,6555,11282,10312,13159,32866,25748,373056,81746,107850,53526,180280,49164,170339,47065,9941,13767,3989,9221,5952,11142,38054,26036,46872,30398
26101,21068,3507,10990,2179,3905,1481,5268,1231,4846,1132,422,451,126,333,296,359,376,387,1441,740,10078,2038,2215,1185,5381,1281,4958,1152,423,496,189,363,234,377,1182,661,1300,742
26103,56686,9967,28516,6381,10935,4759,13592,3513,12882,3282,710,1048,113,668,597,961,1017,1167,2972,2115,28170,6062,9214,4312,13303,3315,12733,3216,570,879,181,658,389,796,2405,1664,3248,2042
26105,24118,4098,11851,2418,3376,1584,6425,1515,6122,1456,303,422,105,263,198,385,446,440,1604,1007,12267,2378,2509,1299,6634,1564,6327,1519,307,418,123,303,184,343,1373,831,1751,1015
26107,36704,6035,18437,3870,7931,3024,8060,1875,7675,1806,385,494,98,352,287,452,491,515,1955,1168,18267,3641,6367,2468,8203,1926,7728,1841,475,588,199,389,276,476,1567,912,2130,1212
26109,19718,2753,9936,1693,2948,1092,5417,1201,5074,1119,343,391,123,238,220,307,334,323,1237,649,9782,1611,2226,947,5253,1118,4980,1095,273,305,103,237,170,254,1061,586,1242,655
26111,68659,11486,33454,7156,9217,4773,20124,4697,19285,4588,839,1241,216,742,623,1111,785,1044,3328,2446,35205,6808,7807,4000,19859,4611,18943,4492,916,1285,319,900,597,1050,3014,2341,4525,2852
26113,12139,1465,6165,845,1517,469,3541,609,3373,584,168,181,98,168,70,90,253,178,854,361,5974,855,1135,424,3558,603,3352,579,206,183,112,154,94,118,543,257,738,330
26115,123597,23774,60587,13774,18386,9224,33503,9122,32131,8887,1372,2237,418,1532,954,1904,1875,2436,6823,5093,63010,14230,15472,8805,33728,9133,32281,8902,1447,2265,627,1716,820,1791,6316,4609,7494,5137
26117,51689,8211,26723,5099,7802,3245,14106,3287,12825,3052,1281,1090,404,679,877,867,921,911,3894,2120,24966,4595,5508,2636,13725,3151,13068,3040,657,830,352,713,305,590,2512,1517,3221,1834
26119,8147,1230,4116,730,889,398,2378,532,2251,522,127,145,35,105,92,115,283,226,566,272,4031,683,565,288,2374,534,2263,525,111,126,53,109,58,111,520,286,572,280
26121,140060,27673,69219,17089,24706,11879,32943,9617,30881,9074,2062,2585,606,1736,1456,2227,2097,2741,9473,6382,70841,16134,20019,10334,33461,9601,31533,9191,1928,2653,877,1937,1051,2097,6932,5113,10429,6587
26123,39402,5385,19720,3140,5384,1938,11324,2148,10593,2017,731,723,190,391,541,615,551,486,2461,1229,19682,3046,4127,1802,11536,2141,10996,2094,540,543,167,348,373,462,1499,842,2520,1175
26125,1036898,189479,502358,115203,171456,82562,274141,70046,259840,66384,14301,20384,3534,12104,10767,17950,12383,17726,44378,35778,534540,114758,150070,76259,272321,68911,258283,65555,14038,20460,5656,13929,8382,16204,45094,34026,67055,43383
26127,21442,3223,10866,2035,3109,1405,6155,1162,5815,1082,340,393,97,235,243,352,336,280,1266,640,10576,1752,2235,982,6116,1093,5830,1053,286,310,127,233,159,224,920,495,1305,663
26129,17756,2577,8870,1497,2124,829,5024,1044,4583,963,441,393,191,271,250,300,437,347,1285,615,8886,1472,1607,761,4879,996,4659,978,220,247,64,201,156,218,1111,563,1289,614
26131,5326,696,2722,384,710,252,1440,285,1363,277,77,90,21,63,56,88,173,118,399,184,2604,430,434,239,1443,271,1383,272,60,81,34,86,26,72,402,180,325,146
26133,19060,2623,9558,1550,2889,1013,5033,928,4762,882,271,291,115,221,156,243,337,294,1299,594,9502,1540,2110,857,5039,910,4745,891,294,285,156,236,138,242,1082,545,1271,614
26135,6934,1151,3479,670,759,372,1924,471,1798,459,126,155,70,138,56,110,189,149,607,340,3455,654,636,324,1931,457,1820,450,111,127,33,103,78,112,391,243,497,291
26137,20303,3060,10033,1853,2938,1203,5660,1240,5403,1213,257,329,129,264,128,214,243,297,1192,729,10270,1790,2203,1068,5948,1295,5611,1235,337,365,152,281,185,254,880,595,1239,704
26139,229408,37016,112311,23423,36723,16360,64850,13762,62316,13127,2534,3673,520,1992,2014,3320,2371,3134,8367,6636,117097,21544,34140,14405,64066,13478,60963,12863,3103,4144,1179,2620,1924,3207,8592,5971,10299,6952
26141,11096,1377,5538,799,1285,473,3376,584,3272,571,104,152,13,148,91,146,314,247,563,284,5558,837,986,419,3353,576,3244,564,109,149,44,116,65,148,688,353,531,306
26143,20930,3731,10415,2221,2498,1323,5563,1427,5323,1389,240,333,77,271,163,287,526,515,1828,1033,10515,2220,1739,1004,5731,1457,5379,1399,352,426,143,283,209,362,1380,885,1665,1013
26145,157981,32223,75785,19694,27476,14199,37455,11088,35079,10514,2376,3250,1200,2623,1176,2419,2549,3437,8305,6416,82196,19296,25936,13032,37179,10961,34736,10464,2443,3369,1112,2497,1331,2541,8741,6044,10340,7439
26147,132222,22976,65173,13966,20750,9727,34798,8619,33025,8355,1773,2507,674,1843,1099,2028,2215,2670,7410,5068,67049,13606,16209,8300,35177,8779,33517,8453,1660,2516,652,1773,1008,2055,6446,4494,9217,5713
26149,48419,8806,23991,5216,6933,3344,13346,3563,12693,3386,653,876,239,652,414,749,799,864,2913,1887,24428,5035,5640,2815,13326,3417,12407,3318,919,990,441,767,478,772,2345,1587,3117,1893
26151,34083,4848,16829,2900,4723,1869,9641,1877,9166,1779,475,540,182,354,293,512,627,560,1838,1025,17254,2798,3658,1552,9689,1889,9190,1809,499,526,238,400,261,429,1788,932,2119,1035
26153,6919,803,3405,512,839,349,1889,328,1745,327,144,123,66,94,78,80,188,173,489,242,3514,453,700,249,1896,338,1767,324,129,141,78,118,51,91,398,187,520,238
26155,56639,9701,27773,5705,8873,4026,15340,3692,14773,3616,567,842,275,714,292,636,957,1055,2603,1813,28866,5607,7353,3476,15317,3682,14711,3603,606,875,270,677,336,708,2720,1738,3476,2045
26157,44106,6625,21986,3880,6195,2591,12526,2622,11964,2525,562,715,238,520,324,601,836,790,2429,1433,22120,3807,4538,2098,12468,2619,11873,2540,595,728,233,541,362,600,2372,1336,2742,1514
26159,60778,12269,30056,7335,9144,5001,16451,4487,15687,4363,764,1064,284,809,480,884,1008,1253,3453,2406,30722,6784,6804,3731,17131,4592,16145,4438,986,1234,456,901,530,931,2889,2117,3898,2522
26161,310358,53134,152923,34687,69861,28315,70003,17205,65878,16118,4125,5321,913,3138,3212,4740,2591,4171,10468,8320,157435,34040,63580,27099,69265,16856,65059,15746,4206,5429,1452,3661,2754,4401,8833,7219,15757,10253
26163,1411900,364270,669792,214963,297056,158457,281827,107483,253314,96783,28513,40312,11701,27708,16812,31576,20481,32472,70428,62641,742108,219262,287551,153897,286545,108157,253650,97031,32895,42466,15968,30739,16927,31174,72577,59404,95435,71808
26165,26743,3885,13306,2346,3753,1495,7215,1568,6725,1486,490,498,234,362,256,343,470,464,1868,997,13437,2282,2854,1273,7261,1550,6794,1478,467,481,200,371,267,342,1312,748,2010,1023
27001,13687,1510,6883,919,1465,581,4224,639,4038,637,186,155,91,141,95,108,332,213,862,331,6804,878,1066,454,4282,674,4099,641,183,192,79,135,104,146,788,326,668,300
27003,280953,47459,139937,28965,46504,21081,77561,18064,73449,17151,4112,5348,1663,3543,2449,4065,2733,4127,13139,9594,141016,28037,38004,18672,76655,17752,72597,16856,4058,5377,1924,3731,2134,3857,9860,7889,16497,10302
27005,27144,3210,13520,1904,4002,1335,7731,1230,7522,1215,209,227,62,188,147,215,431,359,1356,642,13624,1922,3049,1183,7803,1301,7457,1217,346,371,205,300,141,265,1339,623,1433,712
27007,36457,5514,17998,3449,7457,2593,8045,1877,7533,1772,512,559,153,325,359,514,471,536,2025,1289,18459,3453,6561,2553,8047,1921,7571,1814,476,555,193,370,283,442,1401,923,2450,1309
27009,31513,4238,15771,2740,5376,2034,8289,1842,7852,1764,437,533,198,378,239,396,300,382,1806,1202,15742,2612,4535,1883,8020,1716,7624,1670,396,517,153,363,243,389,1313,743,1874,1125
27011,4130,518,2039,317,494,208,1302,243,1251,238,51,55,12,34,39,48,44,44,199,117,2091,310,363,193,1152,201,1117,200,35,44,10,50,25,43,368,143,208,120
27013,55716,8618,27746,5812,13110,5023,12011,2668,11533,2550,478,712,123,460,355,598,586,735,2039,1456,27970,5364,11443,4334,12197,2595,11574,2525,623,724,218,540,405,618,1861,1242,2469,1503
27015,20634,3219,10160,1936,2879,1326,6037,1406,5801,1387,236,346,64,240,172,303,233,294,1011,683,10474,1986,2463,1271,5905,1413,5768,1402,137,267,61,244,76,226,1162,718,944,668
27017,29015,4471,15211,2970,5209,2032,7559,1658,7114,1544,445,498,128,301,317,429,420,445,2023,1152,13804,2464,3282,1402,7598,1630,7271,1561,327,406,190,349,137,277,1338,779,1586,902
27019,79400,9165,39089,5750,11048,4216,24907,3839,24293,3766,614,874,169,553,445,751,569,760,2565,1804,40311,5538,9363,3824,24912,3818,24078,3711,834,1009,241,561,593,883,2160,1495,3876,2159
27021,24079,2370,12206,1419,3072,942,7236,1036,6924,1006,312,259,105,172,207,197,425,277,1473,590,11873,1393,2341,831,7077,1005,6835,982,242,232,81,224,161,200,1190,490,1265,516
27023,9582,1493,4668,925,1298,620,2689,619,2504,580,185,202,86,176,99,128,157,157,524,369,4914,930,1036,548,2842,647,2706,624,136,178,68,141,68,134,531,397,505,361
27025,44986,5526,23317,3449,7817,2580,12925,2311,12381,2222,544,560,104,315,440,498,583,624,1992,1171,21669,3123,4732,2002,13016,2356,12472,2287,544,630,159,335,385,541,1846,1169,2075,1194
27027,50348,8617,24609,5243,9207,3823,13282,3187,12773,3121,509,740,190,555,319,601,497,735,1623,1284,25739,5373,8768,4009,12989,3109,12450,3020,539,677,252,563,287,533,1764,1231,2218,1632
27029,7010,802,3555,501,1164,324,1912,310,1830,299,82,94,20,73,62,91,113,94,366,169,3455,447,802,252,1841,301,1743,295,98,96,61,89,37,69,442,168,370,149
27031,4696,742,2316,441,554,307,1480,323,1387,323,93,100,49,82,44,68,79,79,203,111,2380,406,370,202,1509,357,1457,358,52,67,28,61,24,61,222,145,279,158
27033,9004,1430,4464,858,1332,547,2576,592,2410,568,166,168,50,113,116,152,118,172,438,276,4540,819,846,424,2654,624,2514,598,140,178,31,118,109,161,603,310,437,279
27035,52613,7555,26011,4507,7580,3056,14931,2980,14461,2936,470,615,125,463,345,532,660,666,2840,1620,26602,4351,5936,2651,14875,2954,14288,2874,587,670,211,481,376,565,2564,1460,3227,1749
27037,335754,50163,163740,30758,52496,22562,94776,19718,90259,18711,4517,5491,1268,3158,3249,4698,2995,4247,13473,9629,172014,29981,46338,20669,93747,19239,89023,18345,4724,5639,1776,3586,2948,4402,10841,7929,21088,11798
27039,16205,1838,8083,1144,2486,818,4706,760,4521,730,185,196,58,128,127,180,204,206,687,390,8122,1046,1846,693,4911,766,4782,759,129,167,62,133,67,129,588,336,777,409
27041,30721,3737,15358,2272,4013,1581,9698,1623,9351,1566,347,430,124,300,223,335,412,402,1235,746,15363,2286,2842,1437,9606,1604,9334,1597,272,321,91,232,181,261,1594,761,1321,812
27043,11313,1417,5619,872,1561,573,3260,625,3146,614,114,155,39,122,75,145,176,170,622,333,5694,895,1130,524,3058,600,2973,579,85,143,22,126,63,129,807,418,699,384
27045,16635,1979,8265,1190,1972,724,5305,831,5107,801,198,208,38,162,160,187,231,233,757,384,8370,1137,1549,620,5197,832,4988,783,209,249,83,214,126,210,832,384,792,382
27047,24911,4038,12320,2462,3765,1701,6923,1567,6649,1536,274,385,89,291,185,327,333,364,1299,847,12591,2340,2901,1401,6745,1598,6423,1506,322,456,165,370,157,312,1474,778,1471,889
27049,37719,5418,18687,3245,5266,2150,10967,2312,10495,2226,472,561,160,393,312,463,526,557,1928,1226,19032,3265,3940,1900,10636,2232,10163,2133,473,632,123,388,350,537,1824,1134,2632,1591
27051,4798,469,2428,283,608,173,1530,203,1470,200,60,52,29,39,31,40,57,51,233,90,2370,285,382,158,1459,212,1384,205,75,54,32,39,43,43,252,103,277,105
27053,1014164,193600,498218,123030,200665,92278,245842,71598,229548,67207,16294,21976,4610,12694,11684,18617,9323,15395,42388,35724,515946,116400,174517,81442,248701,71716,231110,66877,17591,23176,6669,14686,10922,18169,32949,28618,59779,42173
27055,15293,1672,7609,1056,2017,703,4581,756,4477,752,104,121,19,83,85,122,281,270,730,412,7684,1002,1610,719,4583,752,4451,749,132,159,49,120,83,135,749,376,742,390
27057,17292,1952,8727,1188,2226,807,5308,755,5090,734,218,195,83,153,135,154,307,229,886,370,8565,1085,1647,607,5175,756,4941,728,234,210,79,125,155,192,774,362,969,431
27059,31616,3809,15901,2409,4993,1801,8671,1558,8177,1487,494,493,199,322,295,388,369,337,1868,873,15715,2312,3731,1512,8521,1511,8039,1491,482,451,162,272,320,344,1194,671,2269,1012
27061,37400,5722,18788,3477,4944,2190,10975,2356,10540,2290,435,589,76,309,359,558,652,620,2217,1222,18612,3296,3507,1730,10901,2332,10505,2272,396,500,150,381,246,426,1943,1193,2261,1378
27063,8213,1133,4172,657,1057,441,2512,505,2444,496,68,107,14,89,54,110,127,146,476,274,4041,697,730,372,2481,515,2407,504,74,132,32,98,42,126,479,250,351,257
27065,13248,1635,6698,957,1955,651,3808,653,3586,632,222,216,62,137,160,176,189,160,746,326,6550,919,1390,544,3689,644,3513,617,176,176,73,147,103,136,690,322,781,359
27067,33990,5072,17031,3133,5301,2258,9889,1949,9398,1858,491,548,112,342,379,482,353,393,1488,981,16959,2869,4144,1793,9496,1833,8896,1742,600,688,211,424,389,558,1644,1015,1675,971
27069,3558,536,1785,338,498,235,1051,242,1003,230,48,73,6,52,42,76,70,66,166,93,1773,309,416,186,1008,223,971,212,37,59,12,38,25,55,196,115,153,98
27071,10689,2249,5319,1330,1484,740,2934,991,2682,914,252,296,136,247,116,202,238,268,663,478,5370,1314,1074,693,2798,888,2573,868,225,275,110,186,115,212,715,474,783,564
27073,5653,605,2820,359,713,217,1750,280,1677,276,73,65,30,62,43,46,128,92,229,117,2833,361,463,167,1789,276,1705,269,84,84,32,53,52,60,353,135,228,117
27075,9024,1503,4617,983,983,548,2797,756,2646,738,151,169,24,119,127,185,295,260,542,362,4407,820,648,411,2836,712,2723,696,113,167,52,150,61,135,475,272,448,326
27077,3139,560,1608,319,456,180,851,229,814,226,37,42,8,21,29,38,55,58,246,135,1531,337,330,177,818,216,733,207,85,56,6,19,79,55,219,130,164,106
27079,22617,2870,11321,1685,3359,1149,6489,1153,6295,1146,194,242,64,202,130,211,233,269,1240,731,11296,1722,2563,1042,6672,1196,6439,1160,233,318,54,218,179,281,818,464,1243,662
27081,4560,450,2280,264,542,171,1390,195,1335,186,55,72,1,38,54,71,123,77,225,89,2280,254,416,149,1324,174,1251,169,73,55,21,43,52,46,340,143,200,85
27083,20255,3023,9939,1897,3519,1347,5490,1247,5290,1217,200,298,81,228,119,234,210,307,720,546,10316,1778,2914,1180,5501,1234,5237,1163,264,369,93,263,171,320,890,524,1011,702
27085,29003,4607,14418,2769,4713,1964,7936,1828,7572,1726,364,478,211,405,153,300,334,400,1435,1024,14585,2652,3492,1664,8004,1834,7658,1769,346,447,58,247,288,426,1386,879,1703,1035
27087,4012,269,1992,193,892,160,844,129,799,127,45,31,16,30,29,26,40,41,216,71,2020,165,673,113,879,115,819,106,60,42,17,25,43,38,220,67,248,77
27089,7593,852,3867,524,1068,332,2353,402,2257,397,96,102,16,77,80,108,102,83,344,164,3726,523,724,276,2294,400,2172,377,122,125,21,71,101,133,352,177,356,181
27091,16224,2718,7984,1697,2083,1029,4591,1135,4353,1070,238,286,110,207,128,232,356,407,954,693,8240,1600,1651,954,4593,1089,4389,1068,204,274,54,166,150,255,1051,630,945,674
27093,18470,2100,9358,1342,2585,851,5486,919,5253,859,233,299,15,191,218,292,280,254,1007,525,9112,1206,1881,703,5362,867,5173,839,189,254,48,169,141,229,965,468,904,467
27095,20779,2255,10409,1380,3438,1025,5194,892,4890,854,304,262,101,155,203,220,432,340,1345,581,10370,1383,2582,847,5377,906,4973,842,404,330,169,197,235,272,993,468,1418,682
27097,26636,3462,13362,2121,4015,1401,7749,1410,7420,1343,329,347,119,261,210,293,378,339,1220,664,13274,1973,2928,1243,7571,1376,7258,1317,313,395,67,251,246,359,1371,738,1404,749
27099,31514,5755,15743,3726,5222,2559,8457,2192,7701,1991,756,845,249,456,507,687,511,551,1553,1160,15771,3224,3932,1978,8212,2046,7731,1959,481,607,151,365,330,529,1758,1106,1869,1195
27101,6807,562,3387,366,877,245,2129,284,2050,272,79,83,40,56,39,73,80,63,301,144,3420,336,556,179,2112,297,2014,286,98,88,42,72,56,80,438,154,314,130
27103,27740,3727,13942,2441,5185,1838,7251,1397,6914,1347,337,396,97,251,240,316,289,360,1217,785,13798,2249,4311,1619,7183,1416,6829,1329,354,458,43,192,311,433,1034,682,1270,781
27105,16661,3255,8673,2056,2743,1284,4864,1295,4438,1169,426,463,84,235,342,388,311,360,755,566,7988,1756,2206,1098,4413,1120,4120,1068,293,395,134,275,159,295,837,535,532,427
27107,5281,675,2675,372,829,237,1461,264,1413,258,48,64,28,60,20,51,107,96,278,138,2606,438,614,233,1400,258,1366,254,34,49,13,49,21,63,314,174,278,138
27109,122727,20397,59296,12782,18869,9012,34259,8014,32708,7639,1551,2082,424,1283,1127,1835,1277,1854,4891,3974,63431,12166,17229,8198,34944,8061,33187,7659,1757,2291,622,1540,1135,1832,4683,3515,6575,4557
27111,47702,6505,23909,4008,6196,2491,14494,2567,13976,2449,518,668,85,379,433,646,881,841,2338,1315,23793,3883,4545,2143,14426,2563,13730,2401,696,813,313,684,383,544,2355,1301,2467,1440
27113,11426,1875,5662,1186,1973,836,2864,742,2734,704,130,196,30,139,100,176,172,203,653,458,5764,1132,1571,801,2933,786,2803,766,130,165,32,150,98,141,579,368,681,454
27115,24496,2509,13103,1665,4547,1223,5938,991,5316,910,622,377,223,223,399,307,530,356,2088,783,11393,1570,2612,916,6026,1010,5600,944,426,351,167,207,259,273,1198,523,1557,631
27117,7242,1112,3468,655,901,412,2107,495,2001,468,106,114,67,107,39,83,100,114,360,239,3774,690,640,347,2269,530,2104,512,165,142,35,105,130,129,504,287,361,231
27119,25118,4131,12627,2504,4111,1693,6777,1590,6406,1526,371,485,166,367,205,381,540,611,1199,817,12491,2409,3042,1484,6749,1593,6372,1526,377,477,154,348,223,386,1454,897,1246,796
27121,9118,1062,4573,646,1116,435,2775,463,2690,463,85,106,19,93,66,98,135,122,547,277,4545,684,683,315,2886,502,2769,485,117,140,55,118,62,124,539,319,437,238
27123,436959,84211,210539,52963,87355,39841,98955,29741,90137,27149,8818,10756,2589,5931,6229,8804,5100,7358,19129,15819,226420,50052,82905,35961,99566,29675,90565,27141,9001,10532,3237,6326,5764,8318,16700,12837,27249,17722
27125,3204,349,1612,206,436,141,960,154,903,150,57,55,15,33,42,50,55,43,161,73,1592,197,331,117,923,155,905,156,18,31,7,29,11,34,151,66,187,88
27127,12188,1340,6155,866,1994,652,3417,582,3285,571,132,153,27,110,105,148,142,155,602,343,6033,795,1329,475,3461,554,3308,540,153,150,72,134,81,114,677,332,566,316
27129,11826,1468,5991,884,1735,546,3423,623,3269,591,154,174,56,136,98,149,174,145,659,334,5835,863,1248,453,3332,599,3182,561,150,189,60,152,90,151,659,311,596,321
27131,54103,7884,27745,5027,10914,3596,13686,3093,12382,2797,1304,1214,418,745,886,871,624,731,2521,1530,26358,4567,8667,3104,13041,2969,12453,2883,588,757,219,545,369,576,2075,1379,2575,1621
27133,7406,957,3651,566,941,383,2352,440,2277,428,75,110,28,66,47,110,88,98,270,184,3755,555,671,312,2476,440,2360,419,116,115,47,78,69,117,362,215,246,173
27135,12290,1367,6331,800,1997,536,3559,542,3394,532,165,148,39,100,126,144,127,131,648,308,5959,779,1342,455,3416,543,3297,525,119,151,10,95,109,151,550,248,651,327
27137,168135,30773,83921,19211,31014,14169,40290,10901,38325,10483,1965,2863,643,2169,1322,2454,2555,3251,10062,6771,84214,18808,25617,12823,40214,10897,38402,10446,1812,2920,629,2259,1183,2457,8146,5667,10237,6909
27139,111852,14406,55456,8993,16701,6657,33576,5729,32314,5513,1262,1558,348,858,914,1261,936,1223,4243,2945,56396,8768,14407,6170,33401,5723,31707,5412,1694,1796,582,1023,1112,1444,3269,2337,5319,3204
27141,73758,11552,37685,7445,13088,5637,20466,4338,19535,4180,931,984,272,586,659,804,627,819,3504,2413,36073,6671,9494,4267,20858,4494,19935,4293,923,1134,384,706,539,879,1996,1513,3725,2509
27143,11997,1631,6089,969,1866,640,3616,682,3450,661,166,169,30,119,136,158,138,129,469,242,5908,922,1142,505,3627,674,3486,663,141,163,56,148,85,130,676,303,463,248
27145,128028,20775,64320,13272,25541,10705,31812,6822,30240,6602,1572,1862,387,1120,1185,1611,1247,1470,5720,3711,63708,12326,20892,9016,32268,6865,30705,6615,1563,1985,545,1246,1018,1620,4452,3101,6096,3978
27147,29005,4078,14491,2529,4504,1887,8392,1674,8168,1641,224,354,65,243,159,322,335,395,1260,891,14514,2430,3334,1581,8337,1674,8020,1609,317,429,211,367,106,284,1336,805,1507,950
27149,8053,1431,4008,870,1633,684,2065,496,1899,437,166,207,8,101,158,205,90,131,220,186,4045,891,1412,688,2138,475,2018,461,120,131,50,126,70,91,348,259,147,134
27151,7604,1037,3762,611,1028,380,2290,491,2140,460,150,169,80,171,70,104,125,115,319,202,3842,643,757,374,2085,451,1971,440,114,126,74,121,40,84,517,274,483,274
27153,19629,2560,10059,1519,2710,937,5962,1078,5677,1017,285,344,104,259,181,252,341,268,1046,521,9570,1456,1923,860,5796,1059,5518,994,278,303,118,270,160,235,939,450,912,500
27155,2796,392,1390,224,325,154,847,194,828,193,19,33,3,40,16,31,78,63,140,84,1406,240,206,92,877,197,851,193,26,38,7,43,19,36,195,88,128,89
27157,17716,2185,8889,1304,2438,913,5324,910,5162,901,162,214,43,179,119,186,275,254,852,466,8827,1278,1804,782,5289,926,5115,904,174,230,67,185,107,196,719,447,1015,563
27159,10774,1957,5245,1248,1633,889,2796,688,2673,652,123,168,50,129,73,161,201,201,615,418,5529,1141,1317,694,2860,717,2727,681,133,194,44,167,89,165,664,437,688,453
27161,15184,2039,7256,1258,2428,919,3974,785,3807,776,167,163,34,101,133,155,173,219,681,463,7928,1289,2155,847,4158,840,3838,786,320,253,119,215,201,219,799,430,816,474
27163,204339,28123,100395,17466,31751,12939,58322,10948,56303,10631,2019,2642,718,1789,1301,2181,1850,2481,8472,5809,103944,16854,26168,11438,59518,11135,56991,10717,2527,3251,954,2093,1573,2494,7120,5065,11138,6569
27165,8710,1610,4331,921,1361,551,2390,652,2215,607,175,216,43,102,132,202,166,172,414,284,4379,961,967,537,2510,680,2287,644,223,238,64,128,159,200,589,317,313,230
27167,5129,788,2629,502,803,359,1511,340,1471,333,40,70,11,59,29,65,84,90,231,164,2500,453,535,274,1419,311,1386,307,33,70,7,69,26,65,319,193,227,166
27169,43216,7639,21348,4618,9378,3877,9722,2215,9407,2140,315,523,101,374,214,466,404,529,1844,1313,21868,4759,8447,3726,9690,2189,9331,2114,359,600,92,377,267,552,1546,1049,2185,1274
27171,103038,15283,51728,9336,15063,6444,30910,6015,29767,5910,1143,1438,369,793,774,1192,1026,1251,4729,3282,51310,8802,11751,5540,31335,6168,30178,5989,1157,1526,370,907,787,1190,3122,2316,5102,3081
27173,7947,1247,4037,749,1193,518,2356,536,2243,519,113,163,47,128,66,129,100,112,388,239,3910,718,848,438,2268,497,2223,499,45,114,18,132,27,100,442,260,352,214
28001,25877,7436,13430,4769,6650,3402,4992,2435,3872,2097,1120,1038,391,700,729,779,459,751,1329,1365,12447,4319,4541,2737,4719,2236,3739,1821,980,1196,619,898,361,723,1515,1212,1672,1306
28003,30115,8001,14533,4758,4329,2883,7565,2697,7043,2507,522,828,282,632,240,518,500,774,2139,1704,15582,4701,3605,2614,7260,2515,6826,2427,434,638,293,545,141,447,1957,1566,2760,2004
28005,10308,3571,4986,1948,1441,1057,2641,1245,2357,1159,284,403,110,242,174,328,291,392,613,628,5322,2128,1312,1241,2814,1296,2526,1221,288,436,234,409,54,207,844,679,352,399
28007,14548,3709,6809,2043,2152,1152,3389,1267,2899,1165,490,492,210,345,280,375,278,339,990,831,7739,2284,2244,1353,3408,1351,2936,1191,472,565,209,358,263,417,1103,758,984,776
28009,6790,1733,3355,895,1096,602,1738,633,1579,610,159,186,89,134,70,143,156,209,365,313,3435,1059,1110,683,1534,599,1324,528,210,250,169,236,41,102,449,308,342,254
28011,25217,6137,11636,3776,5440,2695,4648,1998,3991,1819,657,742,350,483,307,539,445,566,1103,894,13581,3698,5587,2524,4866,1983,4140,1783,726,749,543,643,183,422,1666,1230,1462,1143
28013,11639,2343,5446,1329,1558,801,3140,932,2770,856,370,380,210,290,160,278,187,270,561,441,6193,1379,1670,790,2762,851,2442,786,320,310,225,249,95,224,886,490,875,518
28015,8408,2753,4252,1744,1168,1023,2352,987,2157,930,195,264,105,208,90,205,363,458,369,452,4156,1475,906,770,2398,987,2260,975,138,215,103,188,35,138,378,432,474,455
28017,13584,3495,6504,2030,2638,1356,3118,1188,2791,1119,327,397,203,342,124,257,225,309,523,505,7080,2133,2361,1398,3151,1088,2788,1038,363,412,217,308,146,282,912,640,656,550
28019,6761,1537,3318,953,1016,573,1912,653,1632,566,280,330,191,283,89,135,154,205,236,272,3443,905,903,572,1595,552,1449,515,146,172,55,131,91,161,573,353,372,280
28021,7475,2337,3478,1321,1958,1118,1185,618,943,548,242,267,96,175,146,217,69,144,266,299,3997,1555,2127,1236,1169,630,926,532,243,292,118,208,125,201,380,307,321,289
28023,12874,3431,5939,1932,1695,1200,3159,1186,3037,1162,122,253,67,248,55,214,188,296,897,761,6935,2045,1942,1120,3543,1233,3244,1194,299,405,145,287,154,307,706,599,744,583
28025,15933,4424,7355,2554,2720,1736,3488,1511,3082,1372,406,518,290,435,116,306,294,432,853,761,8578,2691,2982,1760,3529,1487,3204,1398,325,489,188,356,137,340,974,822,1093,876
28027,17934,4824,8060,2855,3533,1887,3421,1632,2760,1391,661,821,517,733,144,403,387,522,719,783,9874,2950,4597,2256,3312,1458,2482,1183,830,784,647,699,183,377,1188,963,777,703
28029,23041,7029,10887,4039,4221,2658,5196,2140,4449,1870,747,905,474,728,273,569,284,484,1186,1138,12154,4176,3796,2380,5528,2331,4532,1927,996,1095,721,961,275,512,1384,1127,1446,1291
28031,15042,4852,7211,2889,2622,1911,3910,1582,3586,1524,324,430,206,368,118,222,198,318,481,607,7831,2631,2190,1381,4049,1591,3541,1530,508,595,347,480,161,348,928,809,664,645
28033,141348,22601,67124,13634,21497,9675,36841,8072,34198,7655,2643,2740,1208,1828,1435,1950,1823,1986,6963,4558,74224,13724,20453,8956,37997,8316,34540,7666,3457,3237,1977,2376,1480,2033,6261,4106,9513,5164
28035,60508,15786,28161,9442,12079,6713,12114,5021,10456,4366,1658,2122,1010,1690,648,1255,861,1403,3107,2872,32347,9719,12963,6565,11826,4841,10283,4389,1543,1978,1021,1608,522,1118,3162,2530,4396,3293
28037,6170,1693,2965,978,750,521,1858,685,1652,615,206,251,10,85,196,253,121,149,236,247,3205,974,920,552,1703,596,1506,545,197,199,92,140,105,168,251,236,331,268
28039,18856,4956,9565,2881,3257,1976,4899,1640,4508,1553,391,419,183,267,208,348,193,322,1216,1043,9291,2852,2529,1725,4791,1676,4386,1567,405,540,134,283,271,434,997,826,974,899
28041,11534,2882,7080,1856,2871,1110,2768,1119,1672,883,1096,450,414,398,682,345,262,232,1179,615,4454,1540,681,642,2411,1119,2303,1089,108,160,53,136,55,147,584,475,778,708
28043,16910,4781,7913,2757,2825,1933,3716,1536,3306,1396,410,562,313,480,97,288,331,509,1041,863,8997,2836,2190,1520,4256,1685,3557,1508,699,790,514,660,185,392,1336,1057,1215,1006
28045,38979,10599,18824,6385,5421,3904,9879,3750,8848,3502,1031,1396,569,1061,462,873,746,1034,2778,2324,20155,6153,4066,2938,10039,3835,9004,3559,1035,1290,664,1064,371,746,2273,1996,3777,3022
28047,163212,39618,79222,23417,27874,15440,39404,13780,35753,12728,3651,4492,1605,3179,2046,3308,2099,3219,9845,7922,83990,23173,25739,14745,38652,13185,34462,12196,4190,4678,2384,3650,1806,3075,7678,6216,11921,8484
28049,190324,48735,86769,28739,39721,21399,36016,14901,31049,13497,4967,5844,2396,3963,2571,4330,2349,4007,8683,8113,103555,30324,43818,21675,36547,15146,30848,13238,5699,6494,3637,5154,2062,3955,9938,8026,13252,9884
28051,13923,3784,6454,2259,3933,1903,1797,888,1378,773,419,402,293,366,126,310,304,364,420,444,7469,2405,4021,1887,1964,953,1411,783,553,508,454,455,99,258,856,557,628,541
28053,6512,1694,3085,946,1505,662,1057,443,855,401,202,202,142,168,60,116,127,156,396,283,3427,1053,1432,752,1025,444,869,389,156,184,138,193,18,105,698,421,272,220
28055,1178,347,750,222,363,183,256,83,161,70,95,58,51,44,44,47,27,27,104,92,428,181,91,88,214,85,179,66,35,44,35,44,0,26,68,52,55,42
28057,19258,4882,9549,2896,2850,1749,5019,1847,4601,1741,418,577,129,326,289,475,386,529,1294,1095,9709,2757,2382,1505,5086,1801,4617,1676,469,556,267,403,202,373,1097,944,1144,913
28059,114922,31479,56035,18492,18457,11533,28216,10989,25233,9867,2983,4268,1330,2672,1653,3026,1859,2766,7503,6527,58887,18252,17201,11037,26918,9964,23908,9126,3010,3801,1588,2586,1422,2705,6106,5120,8662,6581
28061,13375,3640,6446,2183,2076,1355,3453,1387,2928,1243,525,594,215,345,310,425,298,358,619,633,6929,2134,2008,1286,3340,1304,2843,1188,497,581,278,368,219,368,923,760,658,539
28063,5815,2132,2860,1241,1500,809,831,549,597,458,234,231,95,141,139,202,186,220,343,273,2955,1252,1243,809,851,548,587,438,264,288,105,173,159,224,428,348,433,396
28065,9434,2632,4412,1511,1495,1003,2197,951,1956,865,241,340,107,258,134,224,145,246,575,525,5022,1600,1498,1051,2301,954,2024,911,277,333,119,222,158,288,561,501,662,553
28067,53839,16941,25776,9627,8415,5932,13595,5827,12011,5225,1584,2170,966,1688,618,1255,1150,1537,2616,2699,28063,9852,7614,5676,13050,5687,11666,5075,1384,1896,792,1443,592,1223,3755,3132,3644,3297
28069,8488,2835,4251,1830,1992,1164,1622,997,1245,862,377,402,175,273,202,278,123,225,514,483,4237,1540,1657,952,1444,888,1211,803,233,316,71,191,162,256,478,477,658,568
28071,45327,11579,21745,7453,10647,6143,9192,3049,8572,2861,620,894,320,683,300,621,398,638,1508,1437,23582,7108,10458,5085,9260,3063,8414,2799,846,1105,455,822,391,688,1457,1326,2407,2099
28073,48971,10907,23088,6399,7930,4488,12906,3894,12011,3592,895,1253,281,652,614,1027,304,599,1948,1971,25883,6574,7161,3635,13665,4141,11935,3584,1730,1850,1004,1251,726,1027,2160,1743,2897,2251
28075,61298,16995,29422,9911,10705,6482,14582,6001,13204,5555,1378,1928,689,1418,689,1385,1148,1724,2987,2669,31876,10114,9195,6077,14982,6010,13738,5608,1244,1850,743,1426,501,1290,3487,3003,4212,3587
28077,10058,2347,4877,1310,1356,786,2865,956,2588,882,277,335,172,259,105,222,215,265,441,385,5181,1447,1335,863,2604,869,2365,813,239,285,169,247,70,169,664,445,578,441
28079,17986,4998,8991,3020,3660,2092,3871,1599,3434,1458,437,555,226,423,211,391,442,566,1018,925,8995,2875,2773,1571,3927,1575,3394,1444,533,613,385,523,148,332,1141,928,1154,1014
28081,67144,15276,31492,8860,10043,5687,16537,5265,15381,4983,1156,1580,480,1044,676,1270,878,1375,4034,3253,35652,9137,9856,5721,16906,5417,15481,4979,1425,1778,865,1443,560,1131,3470,2400,5420,3592
28083,22361,6787,10170,3966,5453,3003,3551,1871,3161,1722,390,630,231,509,159,467,529,756,637,764,12191,4198,6071,3241,3513,1749,2760,1515,753,810,608,753,145,431,1450,1113,1157,1073
28085,27539,8236,12881,4620,4383,2992,6758,2747,6335,2613,423,693,201,498,222,523,367,668,1373,1308,14658,4765,3949,2860,7844,3098,7015,2823,829,1017,506,802,323,643,1573,1413,1292,1216
28087,47481,12110,22057,7129,7957,4864,11299,4166,10406,3758,893,1309,521,1008,372,894,1030,1254,1771,1844,25424,7285,8609,4547,11210,4007,10132,3692,1078,1350,468,899,610,1053,2809,2209,2796,2354
28089,82781,17021,38928,9765,12290,6421,22789,6373,21209,5939,1580,1937,351,1058,1229,1724,467,1080,3382,3164,43853,10524,12964,6587,22588,6350,20729,5863,1859,2240,830,1460,1029,1569,3457,2787,4844,3499
28091,20208,6277,9742,3631,3195,2403,5012,2254,4303,1835,709,916,330,594,379,619,389,575,1146,1049,10466,3788,2948,1993,5102,2142,4460,1861,642,780,267,499,375,582,1440,1148,976,947
28093,29325,8222,14426,4689,5246,2738,7293,3109,6083,2810,1210,1167,348,630,862,859,381,566,1506,1339,14899,4848,5160,3018,6714,2934,5991,2681,723,977,486,797,237,505,1604,1325,1421,1254
28095,28978,7498,13606,4070,4504,2643,7164,2462,6695,2345,469,694,322,629,147,419,362,583,1576,1379,15372,4613,4132,2900,7541,2688,6707,2389,834,969,522,724,312,638,1979,1403,1720,1343
28097,8150,2205,3842,1261,1149,772,1966,880,1819,849,147,259,61,173,86,225,239,311,488,512,4308,1358,1042,742,1995,925,1739,862,256,330,186,285,70,164,637,454,634,523
28099,22623,5890,10593,3270,3914,2224,5034,2033,4619,1934,415,636,233,529,182,427,427,591,1218,1080,12030,3557,3555,1986,5234,2041,4611,1907,623,771,335,533,288,550,1429,1134,1812,1397
28101,16850,4434,7851,2456,2274,1355,4573,1722,4248,1597,325,518,139,379,186,381,210,357,794,799,8999,2633,2583,1533,4445,1614,4002,1485,443,531,218,410,225,365,1119,864,852,688
28103,8587,2613,3977,1503,1786,1015,1675,859,1475,791,200,296,82,181,118,246,201,261,315,320,4610,1536,1683,948,1965,917,1597,836,368,415,215,287,153,258,571,497,391,402
28105,42243,9977,21002,6797,12129,5487,7423,2802,6797,2650,626,917,204,546,422,716,272,533,1178,1212,21241,5818,10500,4344,7611,2783,6619,2524,992,1073,537,830,455,707,1563,1441,1567,1380
28107,27053,7963,12817,4621,4721,3234,6216,2687,5627,2514,589,708,297,485,292,527,531,668,1349,1208,14236,4560,4540,2921,6136,2637,5576,2508,560,678,384,583,176,382,1712,1238,1848,1440
28109,45005,11772,21970,6782,6178,3969,12491,4254,11332,3954,1159,1319,616,953,543,880,609,882,2692,2227,23035,6547,5155,3425,12572,4175,11371,3967,1201,1261,649,874,552,893,2792,1920,2516,2214
28111,9709,2347,4659,1306,1273,743,2855,905,2592,864,263,303,123,209,140,246,84,173,447,381,5050,1361,1215,722,2645,845,2464,827,181,237,116,207,65,149,543,400,647,467
28113,30894,9052,14365,5403,5610,3713,6952,2913,6024,2617,928,1177,534,816,394,761,457,703,1346,1309,16529,5517,5692,3549,6992,3091,5600,2486,1392,1530,701,967,691,1012,1933,1436,1912,1525
28115,24654,6347,11916,3553,3469,2222,6569,2212,5811,2003,758,808,344,546,414,601,410,534,1468,1208,12738,3667,2942,1868,6895,2352,6186,2125,709,775,365,533,344,522,1154,1049,1747,1274
28117,20425,5835,9758,3454,2901,1970,5452,2253,4980,2058,472,713,273,523,199,438,368,568,1037,1006,10667,3319,2231,1607,5399,2219,4915,2030,484,673,290,534,194,424,1337,1081,1700,1348
28119,5763,1273,2634,748,1136,522,1169,458,924,405,245,232,193,203,52,130,84,129,245,220,3129,823,1168,522,1071,448,822,399,249,219,181,185,68,132,505,304,385,265
28121,123234,25984,58600,15130,17515,9672,33333,9557,30833,9009,2500,2754,842,1695,1658,2187,1465,2173,6287,4898,64634,15531,15350,8837,34332,10215,31207,9220,3125,3683,1250,2104,1875,2726,5965,4435,8987,5941
28123,22019,6637,10597,3920,3899,2401,5361,2339,4572,2094,789,895,445,700,344,582,425,584,912,950,11422,3853,3409,2362,5571,2277,4515,2001,1056,1145,655,881,401,638,1051,905,1391,1253
28125,3536,966,1560,532,573,385,755,335,669,295,86,116,54,87,32,88,104,131,128,149,1976,602,871,460,782,306,694,290,88,117,73,111,15,69,219,183,104,116
28127,21575,8091,10275,4548,3137,2368,5337,2790,4666,2549,671,985,517,824,154,470,328,581,1473,1537,11300,4677,2953,2360,5440,2918,4595,2435,845,971,356,589,489,738,1415,1231,1492,1420
28129,12916,4027,6223,2346,1994,1354,3409,1444,3225,1376,184,335,78,244,106,284,178,297,642,641,6693,2176,1469,893,3675,1517,3361,1436,314,393,197,281,117,287,892,663,657,618
28131,14953,3541,7473,2137,2335,1397,4071,1383,3554,1177,517,555,265,359,252,356,238,309,829,688,7480,2091,1894,1148,4081,1371,3572,1206,509,529,426,503,83,179,563,427,942,737
28133,21177,4693,11378,2965,5974,2185,3713,1497,2523,1246,1190,752,571,570,619,549,424,488,1267,759,9799,2706,4351,1982,3234,1351,2570,1185,664,644,553,577,111,344,1278,857,936,698
28135,11823,2680,6714,2179,3192,1543,2358,1145,1635,936,723,699,285,390,438,489,261,346,903,724,5109,1899,2173,1259,1692,852,1354,760,338,331,220,270,118,226,703,508,541,487
28137,23030,5293,10949,2964,3825,1904,5511,1835,5160,1793,351,457,144,334,207,325,459,575,1154,936,12081,3024,3500,1701,5918,1991,5423,1888,495,596,252,404,243,397,1291,871,1372,982
28139,17611,4956,8413,2856,2886,1735,4477,1724,4220,1640,257,441,178,375,79,264,215,337,835,795,9198,2826,2091,1417,5118,1981,4518,1786,600,717,346,545,254,421,1007,781,982,775
28141,15941,4446,7736,2571,1980,1418,4601,1835,4341,1764,260,414,147,344,113,279,378,445,777,755,8205,2520,1641,1217,4186,1651,3870,1567,316,465,141,315,175,358,1185,861,1193,953
28143,7516,1824,3434,1106,1613,828,1476,564,1174,544,302,268,118,166,184,226,117,185,228,189,4082,1051,1735,659,1583,662,1419,627,164,212,131,184,33,126,276,245,488,376
28145,22561,5858,10992,3411,3496,2167,6231,2120,5591,1901,640,755,300,484,340,554,387,484,878,858,11569,3236,2795,1932,6015,2062,5648,1934,367,527,97,294,270,484,1235,885,1524,1242
28147,11729,4285,5723,2599,1784,1375,2919,1503,2689,1445,230,398,80,243,150,321,335,383,685,719,6006,2378,1509,1299,2966,1504,2492,1315,474,607,156,299,318,500,875,653,656,650
28149,37351,10001,17517,5776,6267,3805,8611,3502,7718,3152,893,1309,536,996,357,812,741,1139,1898,1765,19834,6019,6942,4050,8587,3347,7584,3061,1003,1243,532,901,471,931,2050,1604,2255,1870
28151,36087,10470,16503,5987,6943,4395,6981,3118,6049,2776,932,1300,584,1063,348,895,633,1037,1946,1853,19584,6435,7967,4640,6912,3142,5627,2597,1285,1552,799,1192,486,1037,2318,1837,2387,1889
28153,16184,5494,7826,3208,2327,1893,4238,1942,4034,1865,204,462,202,458,2,212,224,468,1037,1118,8358,3069,2335,1818,4043,1750,3622,1638,421,638,267,521,154,377,1098,1039,882,949
28155,7865,1684,3780,943,1081,581,2193,656,2037,627,156,184,102,172,54,122,140,183,366,282,4085,1001,932,546,2199,641,1992,625,207,238,92,148,115,174,473,319,481,356
28157,7336,2042,3986,1261,2149,953,1320,728,1099,657,221,267,95,188,126,180,143,207,374,345,3350,1207,1308,809,1248,648,932,541,316,324,190,239,126,191,510,352,284,257
28159,14882,3989,7187,2294,2824,1570,3123,1330,2880,1245,243,402,159,346,84,297,459,632,781,733,7695,2426,2241,1453,3368,1361,2986,1281,382,463,233,419,149,319,1162,901,924,864
28161,10046,2825,4758,1534,1407,930,2562,1037,2339,964,223,315,64,170,159,282,176,292,613,534,5288,1768,1416,957,2554,1033,2181,892,373,396,173,244,200,283,786,526,532,462
28163,23250,7911,13766,5992,7683,4731,4236,2156,2763,1597,1473,1120,623,712,850,820,326,482,1521,1162,9484,3294,3773,2135,3407,1629,2733,1385,674,710,476,594,198,435,1310,1054,994,899
29001,21488,5037,10215,3135,4680,2441,4419,1466,3980,1375,439,597,213,424,226,413,381,484,735,703,11273,3218,4934,2429,4200,1381,3875,1311,325,515,176,393,149,380,965,712,1174,1005
29003,14239,2787,7072,1700,1942,1013,4186,1104,4020,1071,166,252,79,180,87,206,238,306,706,533,7167,1565,1465,820,4002,1040,3850,1033,152,220,24,139,128,222,799,540,901,589
29005,4400,569,2167,320,541,203,1228,260,1182,253,46,63,19,59,27,50,63,71,335,162,2233,357,409,192,1262,260,1198,259,64,65,31,45,33,59,338,157,224,119
29007,20877,4627,9293,2657,3012,1682,4649,1518,4350,1434,299,450,160,365,139,334,237,356,1395,1048,11584,2857,3016,1596,5626,1746,4847,1653,779,586,364,463,415,414,1171,780,1771,1119
29009,28861,7924,14151,4514,3334,2370,8581,3166,8047,2951,534,732,267,515,267,528,633,808,1603,1428,14710,4390,2516,1694,8841,3184,8118,2973,723,922,351,614,372,658,1557,1245,1796,1534
29011,9600,2096,4711,1196,1248,764,2712,827,2575,799,137,187,82,156,55,144,301,319,450,344,4889,1224,962,566,2686,822,2512,787,174,234,102,190,72,166,516,406,725,505
29013,13131,2494,6413,1434,1513,769,4103,1051,3827,1026,276,262,108,211,168,203,213,201,584,419,6718,1364,1083,523,3982,1113,3703,1061,279,276,80,146,199,269,767,432,886,544
29015,16402,3620,8116,1986,1722,1016,4727,1320,4411,1277,316,368,84,232,232,317,425,415,1242,869,8286,2100,1358,1005,4595,1336,4316,1254,279,409,157,293,122,278,1375,898,958,647
29017,10057,2551,4950,1423,1354,784,2726,887,2551,841,175,257,64,175,111,191,206,253,664,541,5107,1387,957,691,2788,872,2605,860,183,235,140,225,43,129,654,438,708,494
29019,147284,28545,70659,18049,30717,14058,32799,9011,31017,8627,1782,2430,679,1575,1103,1873,1217,1798,5926,4771,76625,18110,30178,13743,34127,9452,31672,8877,2455,3190,1166,2127,1289,2115,4486,3724,7834,5538
29021,71675,15932,36048,9764,13083,6604,16568,5499,15142,5191,1426,1713,415,1072,1011,1483,1065,1383,5332,3601,35627,9255,9778,5567,16454,5410,14948,5002,1506,1909,592,1211,914,1553,3578,2685,5817,3683
29023,34406,9230,16613,5517,5226,3390,8621,3437,8071,3271,550,887,411,770,139,517,398,691,2368,2038,17793,5235,4038,2661,8455,3323,7898,3190,557,871,376,745,181,508,2405,1806,2895,2081
29025,7287,1218,3657,694,970,390,2048,474,1965,461,83,119,36,104,47,102,149,129,490,265,3630,695,760,356,1946,475,1814,460,132,155,101,133,31,100,405,206,519,300
29027,37106,9052,18908,5388,6365,3203,9327,3096,8427,2883,900,909,296,588,604,734,704,964,2512,1860,18198,5111,4847,3078,9696,3331,9013,3077,683,960,273,613,410,764,1552,1390,2103,1690
29029,38995,9579,19215,5459,5409,3517,10462,3003,9899,2864,563,747,331,616,232,471,463,659,2881,2197,19780,5684,3726,2639,11090,3373,10197,2966,893,1085,290,518,603,949,2103,1714,2861,2111
29031,64434,14558,30857,8646,11259,6044,15575,4908,14628,4672,947,1353,400,928,547,1027,871,1271,3152,2647,33577,8958,9897,5582,16048,5199,14852,4742,1196,1648,591,1144,605,1151,3422,2592,4210,3075
29033,7123,1464,3442,838,931,528,2100,607,1941,563,159,217,61,126,98,186,102,150,309,256,3681,830,714,435,2168,604,2042,591,126,174,62,144,64,145,477,296,322,230
29035,5003,1147,2475,648,702,376,1295,447,1182,431,113,171,47,98,66,124,143,164,335,270,2528,650,499,314,1404,505,1293,476,111,149,93,142,18,61,324,236,301,226
29037,82969,13742,40011,8021,9910,4939,24298,5607,23276,5463,1022,1334,435,946,587,1056,1195,1407,4608,3055,42958,8009,8756,4715,24463,5594,23274,5392,1189,1561,770,1261,419,919,4135,2620,5604,3269
29039,11263,2980,5586,1785,1259,871,3324,1244,3085,1211,239,313,163,281,76,191,272,311,731,629,5677,1670,752,697,3308,1282,3034,1209,274,398,226,358,48,184,603,478,1014,678
29041,6091,1051,2995,620,862,380,1692,359,1604,345,88,117,33,112,55,95,136,141,305,195,3096,618,611,324,1623,354,1548,340,75,113,21,89,54,96,453,258,409,250
29043,67611,10701,32713,6284,7978,3883,20173,4115,19562,4054,611,791,194,507,417,680,813,994,3749,2437,34898,6203,7067,3589,20244,4187,19070,3978,1174,1279,670,946,504,810,2884,1998,4703,2647
29045,5495,879,2758,571,649,297,1588,405,1453,362,135,165,105,163,30,79,138,135,383,248,2737,504,502,279,1554,380,1456,367,98,134,58,111,40,94,343,205,338,190
29047,193546,39995,93854,24120,30628,16411,50022,14484,47464,13739,2558,3893,1198,2775,1360,2825,2228,3452,10976,8578,99692,23862,25576,14283,51011,14742,47322,13826,3689,4487,1831,3162,1858,3286,8033,6470,15072,9829
29049,16601,3238,8116,1791,1896,980,4797,1303,4401,1231,396,395,189,299,207,302,336,341,1087,690,8485,1902,1703,1002,5071,1338,4830,1320,241,349,139,286,102,240,594,433,1117,747
29051,62437,12968,31610,8257,10583,5176,16245,4818,14762,4396,1483,1440,444,915,1039,1169,720,1138,4062,2771,30827,7175,8183,4819,15799,4652,14702,4393,1097,1405,431,934,666,1101,2538,2070,4307,2966
29053,14477,2219,7632,1446,2884,974,3623,849,3281,794,342,233,155,173,187,156,245,237,880,468,6845,1194,1647,743,3452,741,3248,734,204,214,42,111,162,205,869,491,877,482
29055,19613,5202,9643,2993,2431,1546,5339,1887,4742,1749,597,654,279,413,318,494,474,548,1399,1113,9970,2811,1889,1421,5330,1865,4978,1811,352,431,226,375,126,309,1301,970,1450,1114
29057,6308,1250,3150,701,862,374,1826,512,1688,474,138,163,59,115,79,128,103,118,359,216,3158,703,557,310,1720,488,1590,453,130,127,84,129,46,97,470,274,411,256
29059,13339,4165,6454,2394,1394,1158,3773,1529,3590,1474,183,305,109,263,74,221,234,379,1053,863,6885,2385,1297,983,3551,1413,3379,1348,172,287,50,209,122,258,781,670,1256,1056
29061,6549,981,3260,547,812,294,1991,391,1915,391,76,68,38,54,38,82,125,112,332,172,3289,552,663,289,1896,382,1791,371,105,99,59,87,46,62,391,177,339,176
29063,10799,1581,6963,1016,2928,627,2782,762,2111,690,671,261,129,140,542,235,214,208,1039,422,3836,888,663,408,2154,684,1938,637,216,228,63,142,153,180,523,311,496,325
29065,12678,2609,6284,1550,1676,949,3420,1014,3195,947,225,318,93,213,132,231,290,322,898,589,6394,1458,1041,638,3428,968,3220,923,208,271,125,208,83,206,929,597,996,630
29067,10898,2903,5401,1579,1230,814,3215,1080,2993,1021,222,315,77,185,145,240,235,278,721,580,5497,1707,1059,879,3143,1044,2948,1011,195,270,118,215,77,188,629,536,666,597
29069,23652,5258,11114,3074,3544,2049,5459,1882,4895,1793,564,656,258,473,306,496,460,557,1651,1213,12538,3231,3039,1908,5829,2016,5193,1897,636,757,499,691,137,396,1588,1065,2082,1364
29071,83680,16784,41239,9939,12115,6537,23392,6560,21836,6298,1556,1924,746,1310,810,1374,869,1342,4863,3717,42441,9808,8783,5101,23398,6629,21850,6287,1548,1901,906,1502,642,1193,4549,3391,5711,3898
29073,12219,2191,6030,1235,1471,710,3615,866,3433,854,182,199,116,178,66,139,265,252,679,418,6189,1227,991,561,3854,912,3688,898,166,195,104,149,62,143,718,422,626,377
29075,5233,816,2539,496,725,316,1492,334,1392,315,100,97,33,80,67,81,79,87,243,178,2694,469,512,247,1579,354,1514,348,65,97,4,71,61,97,315,164,288,166
29077,238895,42686,114919,27030,40007,19365,59248,17011,55080,16237,4168,4897,1521,3068,2647,3993,3411,4430,12253,9057,123976,25946,35972,16899,59725,16981,55596,16180,4129,5012,2304,3749,1825,3221,11677,7912,16602,10023
29079,8066,1631,3915,1000,1071,608,2123,637,1900,579,223,259,91,176,132,190,171,188,550,384,4151,952,852,528,2149,675,1929,603,220,248,110,192,110,180,577,360,573,390
29081,6750,1265,3306,759,983,487,1810,507,1750,497,60,114,35,115,25,114,105,122,408,269,3444,701,554,328,1954,522,1756,494,198,193,102,139,96,146,425,260,511,307
29083,17757,3566,8704,1992,2046,1087,4901,1372,4630,1320,271,392,139,336,132,269,458,472,1299,875,9053,2127,1697,990,4934,1439,4524,1346,410,474,194,330,216,346,1138,805,1284,857
29085,8109,1904,3999,1052,802,562,2215,717,2034,655,181,225,44,117,137,190,207,213,775,513,4110,1127,595,387,2182,671,1969,635,213,223,68,122,145,176,528,335,805,546
29087,3672,463,1813,284,358,148,1109,214,1067,209,42,69,25,75,17,53,72,71,274,131,1859,269,251,127,1070,222,990,197,80,89,21,47,59,97,297,125,241,105
29089,8216,1528,4116,965,1503,674,2005,529,1925,502,80,152,16,91,64,148,171,208,437,287,4100,836,1136,512,1909,489,1858,485,51,126,34,123,17,113,459,290,596,368
29091,32212,7161,15510,4126,4139,2537,8637,2640,8074,2541,563,819,212,505,351,663,929,1019,1805,1406,16702,4060,3211,2068,9501,2800,8765,2690,736,890,317,598,419,689,1818,1308,2172,1559
29093,8453,1411,4105,776,1029,486,2286,523,2080,505,206,177,154,166,52,95,192,166,598,310,4348,844,781,379,2419,580,2204,552,215,202,92,133,123,145,572,309,576,304
29095,557875,121846,266466,75318,102467,53992,126507,42162,116120,39147,10387,13943,4607,9836,5780,10429,7025,10858,30467,24191,291409,73353,96530,49693,127458,41830,115231,38524,12227,15139,6654,11365,5573,10349,25621,20188,41800,27604
29097,94863,23414,45812,13846,14700,8741,23845,8420,22053,7986,1792,2316,813,1701,979,1728,1574,2079,5693,4747,49051,13452,11916,7357,24909,8742,22980,8256,1929,2604,928,1789,1001,1888,5098,4252,7128,5134
29099,180542,34204,89045,19871,25935,13204,50911,13318,48011,12783,2900,3676,1469,2749,1431,2503,2467,3149,9732,7020,91497,20023,21148,11767,51011,13174,47650,12529,3361,4119,1835,3099,1526,2625,8016,6088,11322,7757
29101,43948,8385,22573,5418,8856,3881,11241,2977,10336,2805,905,924,372,685,533,656,563,678,1913,1490,21375,4806,6594,3191,11258,2952,10557,2815,701,852,301,579,400,658,1465,1191,2058,1434
29103,3211,560,1588,365,525,230,792,219,753,212,39,65,3,39,36,64,94,73,177,124,1623,325,430,211,850,213,790,198,60,87,9,54,51,86,175,88,168,85
29105,28286,6819,13716,3913,3201,2056,8680,2770,8150,2660,530,685,315,530,215,489,460,648,1375,1163,14570,3770,2445,1786,8798,2705,8280,2672,518,669,286,507,232,477,1304,1019,2023,1539
29107,26519,6044,13039,3441,3512,2104,7104,2265,6769,2197,335,563,160,448,175,426,524,618,1899,1401,13480,3423,2991,1863,7144,2241,6813,2168,331,543,216,472,115,372,1510,1127,1835,1379
29109,30237,7239,14905,4124,3879,2377,8921,2958,8324,2873,597,770,237,524,360,581,459,596,1646,1438,15332,4072,2825,2004,8721,2904,8036,2729,685,790,399,618,286,487,1679,1275,2107,1559
29111,8098,1583,4049,945,1393,666,2054,585,1913,563,141,194,73,146,68,160,147,149,455,321,4049,910,1061,533,2159,612,2069,607,90,129,39,107,51,123,413,269,416,288
29113,44690,8608,22062,5017,6892,3257,12346,2959,11637,2826,709,756,213,453,496,647,770,930,2054,1487,22628,4779,5440,2755,12656,3054,11768,2865,888,979,553,749,335,568,2090,1370,2442,1617
29115,9733,1770,4674,1073,1205,707,2765,743,2620,735,145,195,60,167,85,193,131,196,573,394,5059,1035,1039,607,2722,763,2600,733,122,211,53,194,69,182,614,379,684,442
29117,12344,1721,5337,1009,1282,574,3150,726,2913,710,237,254,68,143,169,223,168,186,737,429,7007,1081,1722,647,3564,793,3000,765,564,313,214,216,350,232,779,392,942,397
29119,18029,4152,9083,2297,2485,1296,5256,1558,4946,1506,310,361,162,240,148,273,200,304,1142,836,8946,2357,1837,1064,5296,1550,4964,1513,332,368,230,317,102,223,825,684,988,769
29121,12186,2377,6047,1451,1805,905,3118,861,2832,788,286,356,145,271,141,247,263,273,861,582,6139,1345,1190,719,3254,913,2951,815,303,371,135,273,168,250,855,473,840,524
29123,9948,2425,4783,1337,1073,605,3230,1065,3023,1030,207,248,129,212,78,169,99,181,381,371,5165,1368,1106,637,3111,1006,2859,980,252,283,141,226,111,189,533,392,415,371
29125,7377,1371,3728,797,931,500,2011,538,1911,531,100,129,83,113,17,77,189,214,597,329,3649,778,580,355,2306,596,2105,567,201,206,96,146,105,139,349,231,414,272
29127,22996,4832,11085,2814,3407,1767,6064,1836,5766,1788,298,451,120,390,178,374,388,518,1226,1016,11911,2850,2641,1537,6221,1964,5801,1840,420,574,153,416,267,465,1259,977,1790,1175
29129,2929,515,1450,321,412,196,705,197,678,196,27,42,20,46,7,31,67,70,266,162,1479,296,345,169,722,194,691,188,31,55,28,54,3,28,221,120,191,116
29131,20236,4715,9972,2571,2524,1381,6165,1909,5718,1773,447,564,234,451,213,380,231,371,1052,853,10264,2800,1893,1291,6126,1890,5809,1821,317,426,93,254,224,390,1244,1003,1001,806
29133,11184,2458,6103,1545,2397,999,2559,869,2241,820,318,252,123,195,195,190,250,261,897,593,5081,1344,1188,775,2608,876,2380,848,228,268,117,191,111,223,610,435,675,519
29135,12751,2076,6868,1294,2128,810,3601,817,3184,740,417,288,89,125,328,286,198,222,941,568,5883,1128,1090,574,3550,767,3392,747,158,210,69,165,89,166,647,418,596,421
29137,7150,1362,3597,795,913,447,2050,591,1969,577,81,135,20,112,61,127,110,143,524,345,3553,789,608,326,2036,586,1929,556,107,159,37,108,70,152,413,257,496,305
29139,9361,1653,4597,986,1143,553,2558,676,2433,654,125,181,59,167,66,129,251,271,645,403,4764,973,828,425,2698,696,2536,678,162,228,113,207,49,167,576,374,662,414
29141,16485,3739,8055,2233,1879,1102,4424,1383,3982,1261,442,467,193,307,249,358,280,300,1472,979,8430,2138,1735,1168,4677,1438,4300,1354,377,443,227,338,150,284,1102,777,916,663
29143,14034,3183,6622,1799,1928,1015,3547,1217,3303,1186,244,324,131,284,113,234,336,412,811,615,7412,1905,1577,922,3787,1268,3260,1151,527,518,345,422,182,306,892,605,1156,757
29145,46642,10498,22810,6118,5728,3496,13650,4070,12834,3854,816,1141,288,674,528,893,886,1038,2546,2079,23832,5802,4383,2656,13764,4057,12945,3832,819,1131,369,747,450,857,2393,1819,3292,2279
29147,19431,3566,9614,2337,4501,1972,4220,1022,3841,952,379,360,78,216,301,314,192,242,701,457,9817,2261,4057,1816,4277,1106,4024,1024,253,363,160,285,93,258,593,421,890,673
29149,8639,1946,4235,1139,947,627,2584,812,2375,777,209,255,135,218,74,140,144,176,560,428,4404,1098,718,536,2487,766,2267,732,220,242,115,172,105,173,649,439,550,395
29151,11022,1840,5694,1074,1790,712,3424,735,3289,720,135,187,63,136,72,154,87,133,393,288,5328,1004,1027,546,3431,688,3197,681,234,235,163,190,71,132,484,323,386,288
29153,7752,1851,3770,1066,770,488,2118,719,2022,719,96,155,51,126,45,116,332,303,550,423,3982,1040,665,453,2222,755,2146,746,76,122,38,104,38,118,642,432,453,351
29155,13065,2908,5991,1714,1828,1128,3005,1023,2531,864,474,508,291,384,183,300,310,319,848,582,7074,1824,2264,1265,2918,971,2557,888,361,375,185,253,176,276,883,581,1009,661
29157,15433,2949,7595,1706,2034,1004,4677,1214,4501,1168,176,290,86,249,90,219,186,254,698,592,7838,1629,1482,834,4714,1178,4366,1111,348,387,241,348,107,221,843,557,799,619
29159,33565,7174,16380,4107,4749,2506,9046,2645,8173,2419,873,1022,462,800,411,678,437,606,2148,1462,17185,4149,3954,2322,8926,2606,8310,2444,616,810,283,567,333,614,1881,1278,2424,1586
29161,36758,8487,19276,5376,7935,3609,8732,3142,8453,3065,279,573,117,470,162,498,708,888,1901,1722,17482,4796,4164,2589,9216,3228,8565,3032,651,950,318,687,333,696,1933,1549,2169,1708
29163,15114,2870,8384,1843,2984,1136,3689,1047,3086,947,603,367,199,263,404,296,372,397,1339,643,6730,1554,1425,794,3588,1093,3355,1040,233,336,136,275,97,230,748,551,969,585
29165,80922,15266,39595,9305,12019,6187,22463,6028,20739,5521,1724,2044,899,1427,825,1390,651,1107,4462,3394,41327,9168,10690,5458,22230,5662,20708,5453,1522,1898,909,1490,613,1166,2856,2442,5551,3805
29167,25883,5577,12552,3221,3796,2016,6993,2085,6376,1910,617,781,340,544,277,489,286,390,1477,1225,13331,3171,3351,1818,6809,2038,6279,1880,530,656,269,455,261,429,1343,913,1828,1291
29169,42581,10115,24608,6975,11585,5024,10773,3627,8888,3136,1885,1587,526,898,1359,1064,302,502,1948,1881,17973,5556,5693,3360,9238,3323,8173,2919,1065,1209,320,624,745,932,1036,966,2006,1687
29171,3858,913,1902,529,535,319,1008,353,915,339,93,124,0,66,93,124,128,186,231,207,1956,566,411,310,1009,392,871,324,138,182,98,147,40,98,344,214,192,137
29173,8434,1493,4269,852,997,462,2626,623,2495,631,131,175,52,129,79,139,152,162,494,338,4165,841,742,406,2544,649,2500,639,44,100,14,78,30,112,386,300,493,338
29175,20373,3990,10662,2568,3766,1685,5043,1426,4401,1275,642,535,165,296,477,490,376,455,1477,838,9711,2277,2616,1432,4626,1359,4318,1300,308,408,150,314,158,313,1052,720,1417,866
29177,18616,3447,9213,1996,2445,1168,5472,1385,5213,1303,259,363,157,306,102,207,239,294,1057,739,9403,1950,2001,1109,5193,1290,4996,1257,197,268,92,203,105,213,1152,728,1057,713
29179,5337,906,2771,538,682,334,1578,390,1483,381,95,105,53,83,42,87,116,98,395,224,2566,499,451,274,1478,365,1409,369,69,89,35,67,34,67,380,198,257,150
29181,10977,2654,5422,1547,1480,984,2859,997,2599,954,260,299,125,252,135,201,213,252,870,593,5555,1457,1032,662,2848,1008,2484,922,364,365,218,307,146,238,748,476,927,567
29183,317726,44426,154741,25971,46475,18711,90699,15931,87629,15392,3070,4100,1487,3033,1583,3057,3990,4562,13577,9045,162985,28150,40023,20037,90464,15916,86612,15266,3852,4701,1686,3164,2166,3552,12953,8191,19545,10527
29185,7872,1361,3933,775,861,393,2097,508,1950,489,147,143,52,79,95,127,243,215,732,402,3939,785,570,312,2233,566,2090,529,143,141,42,85,101,140,561,322,575,331
29186,14736,3457,7436,1890,1959,1149,4455,1355,4282,1334,173,264,32,173,141,264,216,318,806,601,7300,2021,1324,969,4587,1378,4410,1377,177,288,79,214,98,240,774,642,615,527
29187,55133,12363,29970,7554,10263,4699,14346,4638,12109,4313,2237,1448,939,1057,1298,1028,1163,1338,4198,2717,25163,6709,5655,3816,13037,4454,12278,4365,759,1055,480,859,279,694,2900,2078,3571,2607
29189,815881,172326,380661,101636,131525,71204,203520,60369,190569,56727,12951,18348,5142,12158,7809,14062,11575,15904,34041,30050,435220,105835,133110,72044,204894,60449,189835,56147,15059,19734,7952,14514,7107,13381,42740,31038,54476,37636
29195,18542,4048,9338,2449,3410,1653,4467,1425,4095,1317,372,452,124,298,248,394,385,464,1076,796,9204,2360,2457,1315,4427,1405,3966,1273,461,528,311,434,150,347,1046,852,1274,923
29197,3566,623,1753,404,571,267,867,203,782,187,85,86,35,66,50,59,47,60,268,151,1813,345,364,152,923,213,813,202,110,91,11,45,99,95,185,106,341,183
29199,3713,1069,1824,630,608,417,1015,390,951,380,64,105,5,66,59,99,34,91,167,151,1889,547,311,251,1056,392,999,375,57,98,19,70,38,100,318,216,204,182
29201,30893,6987,14664,4128,4484,2533,7994,2654,7493,2523,501,723,249,530,252,560,436,658,1750,1403,16229,4132,3815,2337,8151,2704,7410,2453,741,906,431,710,310,589,2109,1507,2154,1549
29203,6725,1562,3252,875,703,437,1980,638,1769,584,211,216,157,202,54,103,157,176,412,266,3473,938,611,411,1600,539,1538,534,62,113,44,99,18,91,511,334,751,443
29205,4819,746,2392,428,581,261,1390,303,1343,299,47,56,19,58,28,53,113,91,308,185,2427,462,430,220,1400,322,1293,305,107,98,28,59,79,85,329,177,268,157
29207,24016,5053,11594,2978,2953,1716,6518,1922,5984,1778,534,647,351,549,183,372,350,464,1773,1295,12422,2922,2479,1451,6100,1839,5603,1683,497,581,273,474,224,366,1805,1211,2038,1205
29209,27416,6625,13326,3657,2536,1694,8658,2575,8064,2411,594,789,186,370,408,655,503,620,1629,1224,14090,3690,2109,1570,8820,2589,8265,2480,555,708,252,464,303,525,1698,1219,1463,1049
29211,5085,1016,2493,629,852,430,1146,315,1050,296,96,92,12,81,84,87,115,117,380,250,2592,555,571,294,1267,342,1117,314,150,168,45,97,105,165,384,209,370,222
29213,45487,9859,21709,5618,5351,2900,12962,3972,12336,3901,626,804,239,508,387,651,540,752,2856,2024,23778,5759,5455,3026,12337,3747,11561,3622,776,930,528,793,248,556,2567,1801,3419,2247
29215,21046,5339,10993,2962,2791,1603,6066,2140,5382,1991,684,672,386,538,298,375,396,528,1740,1205,10053,3085,1879,1376,5513,2016,5157,1917,356,522,228,428,128,308,1484,1194,1177,934
29217,16558,3375,7884,1991,1941,1074,4595,1378,4350,1358,245,327,126,249,119,255,257,339,1091,903,8674,2024,2016,1059,4589,1393,4314,1362,275,370,135,259,140,271,1010,754,1059,815
29219,27576,6028,13638,3408,3775,2084,8063,2322,7742,2255,321,464,192,389,129,302,314,432,1486,1202,13938,3313,3225,1840,8280,2391,7833,2244,447,557,251,417,196,372,1115,936,1318,1071
29221,20245,4746,10466,2752,3320,1516,5531,1747,5059,1678,472,465,216,339,256,338,477,545,1138,825,9779,2627,2117,1369,5556,1699,5057,1667,499,518,195,322,304,403,961,725,1145,845
29223,10898,3149,5368,1783,1301,831,2894,1240,2596,1138,298,416,171,346,127,263,214,277,959,723,5530,1753,839,631,2962,1218,2553,1118,409,415,310,342,99,238,741,595,988,743
29225,29956,5256,15198,3207,3942,1877,8900,2110,8402,2054,498,465,131,303,367,406,355,436,2001,1245,14758,2869,2877,1467,8817,2097,8144,1957,673,771,354,551,319,463,1347,846,1717,1043
29227,1699,208,813,121,157,77,535,107,502,101,33,28,11,34,22,27,43,42,78,46,886,131,122,59,541,108,519,110,22,21,9,12,13,36,92,45,131,75
29229,14386,3639,6966,2107,1776,1161,3767,1386,3510,1317,257,402,142,300,115,289,383,449,1040,786,7420,2127,1304,942,3905,1346,3605,1288,300,407,199,341,101,275,969,777,1242,945
29510,257004,73276,122911,44326,64263,34362,41663,21419,35465,18874,6198,8479,3260,6383,2938,6213,2574,5672,14411,13638,134093,45512,61653,33550,42879,21934,35432,18923,7447,9787,4272,7500,3175,6508,11473,11179,18088,14992
30001,8083,1345,4041,832,1310,588,2200,548,2032,503,168,186,20,82,148,170,57,84,474,298,4042,830,1026,551,2260,576,2167,564,93,109,7,81,86,107,354,274,402,267
30003,9544,1792,4610,1061,1866,713,2249,641,1992,561,257,270,77,147,180,200,188,179,307,250,4934,1038,1622,612,2466,657,2203,614,263,250,166,202,97,161,284,206,562,359
30005,5017,844,2466,513,895,332,1150,333,1013,308,137,124,34,73,103,109,163,117,258,182,2551,501,823,302,1235,361,1086,324,149,151,73,118,76,98,256,145,237,170
30007,5028,779,2564,448,827,399,1293,309,1255,307,38,58,14,41,24,49,115,117,329,195,2464,495,481,301,1374,293,1292,286,82,107,58,89,24,56,273,175,336,225
30009,9099,1633,4603,932,1134,566,2495,587,2355,562,140,164,46,117,94,145,139,165,835,458,4496,1035,889,489,2329,576,2255,574,74,146,37,117,37,125,541,399,737,479
30011,1070,146,544,91,100,70,371,73,362,71,9,14,0,20,9,14,16,19,57,35,526,86,72,62,343,67,342,67,1,13,0,20,1,13,62,31,49,28
30013,65990,13642,33077,8363,10128,5585,17861,5397,16714,5005,1147,1558,397,1015,750,1262,1081,1359,4007,3053,32913,7912,7528,4863,17436,5136,16437,4963,999,1376,306,911,693,1181,3186,2552,4763,3281
30015,4609,616,2304,342,697,245,1330,274,1237,272,93,88,25,50,68,76,72,53,205,106,2305,369,556,224,1321,280,1229,259,92,101,10,62,82,97,246,143,182,111
30017,9643,1774,4722,1113,1376,719,2548,710,2375,664,173,244,82,184,91,186,178,230,620,441,4921,1049,1109,605,2534,708,2299,643,235,288,96,175,139,237,731,488,547,385
30019,1425,198,765,142,207,86,422,91,410,92,12,21,0,20,12,21,24,20,112,57,660,85,71,43,398,88,385,89,13,14,0,20,13,14,126,44,65,39
30021,7428,1833,3925,1155,948,687,2353,802,1990,739,363,317,111,159,252,270,133,172,491,476,3503,1062,659,566,2214,845,1897,762,317,393,63,170,254,341,416,330,214,241
30023,8022,1975,4290,1278,1542,914,1958,733,1719,687,239,248,72,155,167,224,185,234,605,472,3732,1142,974,721,1844,737,1754,717,90,183,49,150,41,143,418,318,496,409
30025,2296,441,1136,276,268,157,731,224,683,222,48,65,16,44,32,51,36,34,101,90,1160,284,250,182,632,182,632,182,0,30,0,30,0,30,212,142,66,74
30027,9253,1350,4648,830,1144,514,2813,659,2566,628,247,260,83,144,164,183,183,185,508,308,4605,798,869,368,2598,610,2405,610,193,179,91,118,102,122,521,308,617,360
30029,81625,18909,40318,11116,11245,7274,23297,7035,22039,6715,1258,1815,497,1210,761,1319,1067,1517,4709,3686,41307,11040,8722,5969,23337,7184,21751,6687,1586,2119,755,1395,831,1432,3732,3151,5516,4141
30031,89720,13523,46734,8884,20052,6995,21894,4963,20975,4811,919,1302,114,629,805,1254,644,1034,4144,2831,42986,8009,13929,5740,22700,5006,21354,4818,1346,1556,460,931,886,1289,1823,1698,4534,2917
30033,871,90,436,56,109,38,294,38,284,38,10,10,0,10,10,10,0,10,33,18,435,49,75,31,283,41,271,35,12,15,0,10,12,15,22,10,55,24
30035,9975,2733,4910,1742,2169,1159,2079,1052,1640,708,439,591,35,165,404,576,150,206,512,434,5065,1485,1729,1019,1978,799,1719,719,259,303,43,160,216,291,415,349,943,656
30037,637,73,320,39,36,19,235,37,201,34,34,20,21,16,13,13,9,4,40,19,317,44,41,23,218,36,209,36,9,9,4,6,5,5,22,12,36,15
30039,2833,424,1452,295,382,206,624,163,568,163,56,57,20,35,36,45,91,79,355,173,1381,222,279,111,739,175,698,167,41,63,41,63,0,30,112,81,251,129
30041,12557,2756,6312,1611,2348,1105,2994,1017,2794,984,200,300,126,259,74,198,204,276,766,626,6245,1693,1807,1038,2899,1005,2682,937,217,326,126,285,91,220,692,581,847,640
30043,10047,1731,5106,1073,1314,666,2956,628,2870,615,86,140,18,94,68,132,143,172,693,427,4941,1000,940,538,3070,675,2899,651,171,213,42,115,129,197,396,308,535,408
30045,1672,179,910,111,248,83,489,76,462,74,27,22,7,10,20,19,14,14,159,60,762,100,113,59,500,80,471,77,29,23,14,25,15,16,64,31,85,44
30047,24085,4163,11783,2579,3591,1759,6520,1619,6036,1557,484,557,195,392,289,415,389,420,1283,852,12302,2413,2771,1424,6574,1678,6148,1585,426,511,113,288,313,450,1163,822,1794,1066
30049,55611,11780,27379,7007,8444,4673,14411,4198,13815,4102,596,956,206,665,390,821,677,1011,3847,2866,28232,6991,6621,3849,14907,4308,14026,4089,881,1237,406,860,475,881,2389,2083,4315,2957
30051,1929,310,865,158,166,106,543,121,498,118,45,34,28,21,17,32,41,44,115,62,1064,217,332,166,518,117,506,116,12,15,5,17,7,12,105,50,109,65
30053,16740,4115,8250,2390,1919,1295,4782,1590,4545,1522,237,361,60,216,177,306,380,441,1169,886,8490,2396,1394,1037,4924,1619,4625,1554,299,381,98,227,201,345,855,710,1317,1060
30055,1416,226,744,124,220,72,470,110,445,106,25,32,0,20,25,32,27,26,27,25,672,124,61,46,488,105,470,106,18,21,0,20,18,21,104,46,19,27
30057,7252,1227,3798,754,1022,504,2096,514,1940,476,156,164,34,60,122,158,183,179,497,262,3454,677,497,303,2141,511,2028,488,113,131,28,85,85,112,347,224,469,297
30059,1544,307,824,214,247,156,389,110,383,110,6,9,0,20,6,9,30,39,158,86,720,166,72,76,435,116,401,106,34,51,3,15,31,51,107,57,106,74
30061,3638,576,1871,376,595,269,908,240,825,229,83,71,18,47,65,62,104,107,264,155,1767,336,365,181,967,237,928,240,39,43,23,35,16,34,235,135,200,101
30063,98674,21202,49156,13383,20874,10660,23246,7498,22189,7307,1057,1685,504,1238,553,1236,800,1409,4236,3591,49518,12725,15990,9044,23077,7480,21974,7343,1103,1657,712,1424,391,1040,3248,2939,7203,4900
30065,4033,693,2009,402,441,221,1249,322,1182,312,67,97,16,58,51,93,58,73,261,156,2024,396,271,146,1312,329,1239,327,73,96,34,66,39,76,250,150,191,137
30067,14005,2880,6918,1722,1724,997,4032,1220,3842,1192,190,270,68,220,122,230,192,273,970,742,7087,1727,1462,974,3934,1165,3862,1156,72,194,7,175,65,189,694,565,997,705
30069,372,60,180,30,26,18,115,20,113,20,2,2,2,2,0,10,9,9,30,14,192,44,19,11,126,26,121,26,5,5,5,5,0,10,28,30,19,14
30071,3271,673,1651,410,640,313,834,238,809,236,25,43,7,30,18,38,57,66,120,87,1620,388,228,176,942,276,903,275,39,64,5,37,34,60,271,139,179,143
30073,4766,745,2350,500,805,375,1228,307,1083,250,145,140,55,80,90,123,97,107,220,170,2416,400,603,210,1237,290,1130,271,107,121,48,82,59,92,269,168,307,186
30075,1405,198,697,123,133,81,467,89,436,87,31,27,8,19,23,22,14,17,83,52,708,106,135,71,437,80,428,81,9,15,0,20,9,15,102,50,34,24
30077,6022,1106,3884,817,1215,470,1871,564,1545,510,326,134,77,107,249,120,139,145,659,262,2138,492,395,260,1358,409,1307,411,51,103,22,88,29,88,190,169,195,181
30079,1008,115,517,65,62,29,336,59,325,58,11,8,0,10,11,8,38,23,81,44,491,67,98,44,325,50,307,51,18,19,0,10,18,19,26,21,42,25
30081,35958,7446,17686,4522,4213,2687,10394,2878,9877,2773,517,743,93,399,424,667,606,715,2473,1803,18272,4341,3365,2268,10736,2936,10235,2885,501,681,261,523,240,505,1666,1396,2505,1701
30083,8864,1610,4577,1015,1512,706,2314,666,2190,636,124,183,102,168,22,84,244,242,507,313,4287,1020,981,595,2375,648,2287,641,88,130,19,77,69,122,419,285,512,348
30085,7988,1541,3963,973,1943,757,1449,435,1274,382,175,206,38,119,137,178,113,123,458,307,4025,864,1579,598,1472,466,1276,395,196,220,21,109,175,212,416,235,558,289
30087,7016,1333,3430,728,1040,418,1887,487,1765,481,122,137,23,84,99,123,186,231,317,236,3586,785,1010,418,1909,517,1797,518,112,135,21,85,91,130,326,229,341,257
30089,9977,1821,5094,1112,1210,634,3040,765,2720,735,320,288,89,126,231,250,207,169,637,393,4883,986,829,482,2810,745,2683,720,127,154,54,118,73,119,521,297,723,441
30091,2852,448,1403,260,387,168,844,200,818,196,26,48,13,43,13,47,36,39,136,93,1449,269,303,163,818,194,782,189,36,54,10,35,26,50,131,85,197,104
30093,28867,8312,14430,4732,5360,3304,6723,2674,6258,2529,465,766,208,541,257,604,569,747,1778,1495,14437,5039,3941,3134,6575,2739,6242,2555,333,714,164,537,169,533,1565,1256,2356,1843
30095,7804,1082,3899,596,910,364,2389,444,2261,430,128,136,42,83,86,114,113,105,487,302,3905,630,707,345,2485,468,2431,459,54,82,32,86,22,66,326,203,387,260
30097,3107,675,1534,387,469,262,897,241,862,239,35,48,20,49,15,44,49,54,119,89,1573,361,215,117,1012,284,960,279,52,71,29,65,23,50,174,111,172,117
30099,4856,708,2399,421,610,258,1480,326,1412,310,68,77,14,56,54,73,103,98,206,132,2457,420,439,231,1472,294,1428,295,44,72,10,69,34,66,303,130,243,147
30101,4185,1045,2356,620,773,410,1218,480,1052,412,166,173,35,94,131,149,44,81,321,203,1829,581,336,234,1085,436,1013,416,72,131,35,91,37,110,213,174,195,178
30103,584,74,281,36,26,13,188,32,184,31,4,8,0,10,4,8,20,16,47,21,303,59,41,24,198,49,196,49,2,2,0,10,2,2,43,32,21,20
30105,6130,1144,3011,658,783,393,1787,492,1746,487,41,85,17,80,24,67,83,100,358,275,3119,689,583,343,1890,549,1856,555,34,72,12,80,22,62,312,211,334,257
30107,1676,242,798,151,277,107,425,96,377,91,48,38,6,8,42,38,17,18,79,40,878,136,201,91,450,101,412,94,38,32,9,11,29,33,139,68,88,56
30109,863,84,410,46,97,35,276,45,276,45,0,10,0,10,0,10,17,11,20,12,453,51,73,36,300,42,293,40,7,12,2,3,5,11,61,26,19,17
30111,127518,25957,62389,15785,18865,10361,33947,10248,32349,9851,1598,2524,693,1762,905,1860,1765,2541,7812,6000,65129,15041,16023,8994,34497,10364,32857,10102,1640,2369,757,1743,883,1761,5932,4339,8677,5877
31001,25316,5010,12590,3134,4256,2094,6598,1889,6343,1832,255,437,37,292,218,408,432,558,1304,1063,12726,2908,3120,1845,6661,1893,6307,1832,354,539,152,377,202,431,1383,967,1562,1139
31003,5099,715,2534,407,649,241,1513,299,1484,297,29,72,7,80,22,72,99,87,273,167,2565,417,431,201,1577,328,1532,323,45,84,16,74,29,70,352,172,205,109
31005,323,39,152,23,36,14,91,20,83,19,8,7,2,2,6,7,13,11,12,6,171,23,22,8,93,17,83,15,10,9,3,7,7,5,28,13,28,12
31007,588,60,273,36,29,22,224,30,218,31,6,8,6,8,0,10,0,10,20,15,315,44,28,23,261,41,229,37,32,24,22,23,10,7,20,15,6,8
31009,382,41,198,27,38,17,142,23,142,23,0,10,0,10,0,10,3,4,15,11,184,21,5,6,141,20,134,21,7,7,5,6,2,3,25,16,13,7
31011,4246,710,2101,425,500,208,1315,322,1272,310,43,71,5,66,38,68,76,83,210,141,2145,385,333,167,1315,332,1297,331,18,35,8,52,10,53,328,148,169,127
31013,8642,2117,4293,1245,1143,793,2413,799,2342,796,71,171,21,120,50,156,214,242,523,471,4349,1209,917,781,2405,829,2269,797,136,216,31,137,105,196,505,377,522,435
31015,1619,175,813,98,159,55,559,81,544,80,15,14,2,12,13,22,34,27,61,33,806,96,113,46,509,81,496,82,13,16,0,20,13,16,127,50,57,26
31017,2489,279,1197,151,255,105,765,135,727,139,38,49,3,15,35,48,49,36,128,66,1292,174,230,92,743,145,693,149,50,39,15,20,35,35,226,96,93,56
31019,39504,6798,19533,4357,7215,3197,10203,2611,9810,2490,393,657,93,423,300,584,530,710,1585,1270,19971,4197,6066,2860,9982,2459,9459,2358,523,709,264,548,259,488,1757,1303,2166,1378
31021,5289,570,2534,341,598,213,1568,258,1516,253,52,62,14,35,38,52,113,81,255,142,2755,336,388,173,1648,254,1563,251,85,66,52,50,33,50,359,158,360,155
31023,6503,856,3281,504,899,306,1945,378,1864,365,81,100,56,97,25,46,117,109,320,182,3222,509,584,273,1990,385,1877,379,113,132,58,76,55,83,363,161,285,169
31025,20755,3444,10375,1850,2715,1202,6366,1360,6132,1327,234,308,74,222,160,260,262,320,1032,663,10380,2047,2044,1077,6475,1356,6182,1312,293,334,101,216,192,269,969,686,892,599
31027,6698,921,3345,514,814,317,2205,403,2138,401,67,83,19,66,48,85,118,113,208,126,3353,553,576,266,2130,405,2089,395,41,87,18,89,23,88,453,220,194,125
31029,3061,622,1478,309,344,161,965,255,938,253,27,40,7,23,20,35,54,54,115,88,1583,369,320,181,934,266,907,265,27,42,5,37,22,45,223,123,106,92
31031,4716,923,2390,562,615,352,1433,409,1417,408,16,67,5,67,11,65,114,147,228,174,2326,520,460,265,1421,393,1354,377,67,102,4,67,63,102,255,213,190,166
31033,7732,1433,3860,834,1032,500,2121,556,1939,533,182,182,84,151,98,158,163,192,544,355,3872,858,646,396,2238,618,2100,585,138,193,31,107,107,182,514,336,474,340
31035,4925,602,2499,369,690,241,1488,272,1429,268,59,68,19,48,40,55,99,85,222,116,2426,336,389,156,1512,271,1431,262,81,84,42,74,39,66,314,134,211,111
31037,8009,2243,4405,1402,1608,968,2290,880,2179,821,111,188,18,116,93,173,122,149,385,299,3604,1100,689,529,2260,845,2105,741,155,236,30,115,125,224,413,303,242,217
31039,7134,1146,3582,679,843,434,2237,485,2123,476,114,139,15,80,99,131,177,160,325,253,3552,665,752,394,2101,462,2037,457,64,96,15,64,49,95,437,242,262,193
31041,8695,1599,4330,908,1233,550,2701,713,2567,695,134,173,81,169,53,132,123,169,273,214,4365,924,880,524,2556,667,2441,656,115,177,31,115,84,172,486,255,443,280
31043,15234,3669,7677,2102,2439,1294,4386,1490,3983,1381,403,448,108,230,295,358,130,224,722,564,7557,1983,1700,1042,4315,1454,4023,1371,292,380,67,181,225,332,729,512,813,644
31045,7514,1694,3599,1001,1375,673,1775,611,1726,612,49,99,27,107,22,72,61,128,388,386,3915,1141,1576,844,1693,628,1609,601,84,154,6,79,78,147,313,276,333,296
31047,18379,4466,9573,2882,2882,1805,5595,1894,4978,1668,617,699,215,409,402,567,252,367,844,790,8806,2275,2004,1220,5044,1616,4730,1572,314,413,119,304,195,319,875,638,883,708
31049,1515,188,731,107,156,65,457,78,442,78,15,19,2,13,13,18,16,15,102,53,784,104,136,64,447,80,420,77,27,23,13,13,14,20,114,41,87,39
31051,4541,588,2285,356,639,214,1305,254,1255,252,50,67,16,52,34,67,53,56,288,137,2256,329,399,176,1432,266,1391,268,41,56,22,61,19,52,257,101,168,90
31053,29308,5877,14233,3410,3939,2087,8369,2506,7844,2347,525,640,129,405,396,552,428,603,1497,1121,15075,3370,3446,2124,7989,2273,7602,2210,387,555,245,512,142,352,1650,1055,1990,1355
31055,439125,93650,214415,57080,80085,40756,109552,33815,101177,31149,8375,11366,2765,7311,5610,9399,4579,7792,20199,17576,224710,55712,71990,37762,109074,33196,101168,30938,7906,11002,3623,7880,4283,8307,16051,13633,27595,20321
31057,1506,299,757,172,171,95,442,139,404,135,38,52,3,24,35,52,20,31,124,68,749,168,137,86,399,131,384,130,15,22,3,25,12,20,110,61,103,51
31059,4677,533,2291,349,572,229,1384,263,1249,231,135,108,36,61,99,93,81,78,254,139,2386,303,373,151,1389,245,1314,240,75,82,17,39,58,76,317,135,307,148
31061,2529,261,1230,158,268,111,763,132,723,129,40,38,10,18,30,43,36,36,163,69,1299,149,223,80,790,137,759,132,31,43,10,24,21,54,199,81,87,51
31063,2230,235,1130,143,297,99,674,115,657,113,17,26,13,24,4,24,57,43,102,53,1100,141,234,72,686,104,670,105,16,17,7,11,9,11,94,42,86,50
31065,3898,570,1918,338,394,197,1256,249,1196,243,60,64,13,43,47,64,84,66,184,102,1980,329,332,192,1200,242,1141,232,59,66,12,47,47,60,266,122,182,106
31067,17544,3261,8681,1977,2310,1258,5036,1307,4870,1261,166,303,54,224,112,274,361,426,974,687,8863,2048,1837,1307,4779,1225,4490,1179,289,346,128,278,161,264,1064,633,1183,792
31069,1569,217,788,122,147,66,535,113,523,112,12,15,2,13,10,13,45,29,61,39,781,120,124,61,488,96,481,96,7,10,1,12,6,9,94,48,75,35
31071,1686,229,837,131,171,61,567,114,551,114,16,23,3,15,13,22,23,18,76,47,849,119,119,56,528,110,504,113,24,33,14,27,10,27,126,63,76,46
31073,1751,187,851,109,184,60,555,93,539,91,16,16,5,16,11,14,37,26,75,42,900,112,178,69,575,91,547,90,28,22,0,20,28,22,88,55,59,34
31075,577,47,313,35,95,27,187,20,187,20,0,10,0,10,0,10,8,6,23,12,264,31,44,23,187,20,180,20,7,5,3,3,4,4,13,7,20,11
31077,1921,141,948,82,229,48,612,75,595,77,17,16,0,20,17,16,46,31,61,32,973,77,194,44,573,74,532,68,41,30,17,15,24,25,137,41,69,33
31079,47113,10414,23483,6385,7664,4087,12687,4152,11474,3843,1213,1448,372,817,841,1154,661,956,2471,1978,23630,5872,6151,3594,12427,3840,11359,3618,1068,1241,559,923,509,894,2352,1953,2700,2002
31081,7467,1174,3656,647,891,427,2448,486,2332,476,116,136,47,125,69,86,78,94,239,190,3811,737,682,401,2343,494,2314,495,29,70,7,70,22,66,333,194,453,319
31083,2736,334,1404,197,316,112,854,154,829,150,25,35,2,23,23,35,36,33,198,88,1332,191,218,95,815,152,782,150,33,42,13,34,20,38,138,58,161,65
31085,724,57,385,42,95,34,232,32,225,31,7,6,7,6,0,10,20,16,38,19,339,33,35,19,246,33,238,33,8,11,8,11,0,10,44,17,14,10
31087,2283,285,1120,172,319,118,598,140,577,138,21,34,3,33,18,33,46,38,157,89,1163,176,190,94,628,134,591,128,37,43,10,30,27,40,178,86,167,80
31089,8066,1612,4017,950,1008,577,2553,716,2456,703,97,140,2,104,95,137,178,226,278,237,4049,898,663,406,2500,709,2442,702,58,123,23,116,35,119,570,351,316,257
31091,607,73,300,47,84,30,155,39,146,38,9,13,0,10,9,13,9,9,52,27,307,52,60,24,154,38,149,37,5,7,0,10,5,7,45,24,48,25
31093,5103,650,2557,419,532,273,1612,296,1578,293,34,62,13,57,21,58,215,180,198,135,2546,358,340,160,1731,296,1684,292,47,57,17,46,30,52,255,128,220,125
31095,5862,732,2859,461,718,277,1610,359,1506,350,104,107,29,73,75,92,148,131,383,205,3003,443,547,244,1568,358,1462,351,106,96,22,66,84,90,485,189,403,205
31097,4378,439,2665,338,988,249,1180,244,988,215,192,97,51,54,141,83,74,60,423,143,1713,212,275,106,1042,185,1010,183,32,30,7,20,25,29,196,87,200,88
31099,5165,720,2535,433,630,256,1571,319,1474,297,97,106,11,45,86,98,56,70,278,179,2630,418,513,247,1485,296,1461,301,24,50,3,44,21,47,365,208,267,159
31101,6696,1129,3393,696,728,380,2071,529,1951,527,120,152,46,125,74,120,165,167,429,333,3303,671,513,343,1959,502,1884,490,75,120,39,105,36,90,412,272,419,286
31103,634,81,302,49,80,32,200,41,183,31,17,24,14,23,3,7,8,8,14,11,332,54,92,38,191,33,183,32,8,10,6,9,2,3,42,20,7,9
31105,2989,491,1489,314,335,163,837,231,781,211,56,74,45,66,11,37,71,72,246,140,1500,287,248,134,807,194,772,193,35,36,6,31,29,44,240,147,205,108
31107,6744,694,3331,437,834,294,2133,285,2073,286,60,58,11,50,49,61,90,71,274,128,3413,388,566,196,2132,306,2048,296,84,78,19,50,65,67,479,163,236,113
31109,252786,43286,126302,28415,51269,22493,61722,15792,57995,14718,3727,4890,1018,2874,2709,4217,2621,3806,10690,8131,126484,26242,42706,19371,61314,15625,57925,14724,3389,4794,1355,3156,2034,3773,8441,6615,14023,9415
31111,28398,6113,13851,3602,3661,2175,8145,2612,7591,2446,554,814,151,453,403,697,578,728,1467,1303,14547,3793,3087,1991,8312,2530,7904,2491,408,659,131,422,277,578,1043,991,2105,1764
31113,731,71,367,41,90,32,240,29,228,30,12,12,1,3,11,11,14,10,23,12,364,42,82,29,223,30,219,30,4,6,4,6,0,10,35,13,24,16
31115,532,49,278,39,89,30,175,26,173,27,2,4,2,4,0,10,5,7,9,6,254,27,26,14,185,25,185,25,0,10,0,10,0,10,26,16,17,10
31117,344,51,167,30,17,12,125,28,120,29,5,5,0,10,5,5,12,9,13,11,177,29,15,8,121,27,121,27,0,10,0,10,0,10,31,17,10,11
31119,27634,4930,13692,3050,4317,1994,7746,2067,7392,1950,354,542,117,397,237,423,441,557,1188,983,13942,2867,3793,1845,7426,1916,7032,1818,394,581,155,407,239,474,1390,912,1333,1048
31121,6364,1033,3210,630,758,375,1882,476,1818,468,64,92,38,88,26,70,107,147,463,284,3154,582,563,283,1941,486,1878,475,63,100,29,76,34,94,324,186,326,202
31123,3838,678,1954,384,565,212,1022,262,955,258,67,73,36,75,31,44,142,119,225,125,1884,396,397,204,1057,289,958,265,99,114,17,55,82,103,221,117,209,149
31125,2901,504,1440,305,377,188,876,229,842,230,34,56,16,55,18,51,53,68,134,109,1461,275,269,146,829,213,806,211,23,46,17,50,6,40,206,106,157,96
31127,5767,971,2860,607,926,428,1602,487,1524,475,78,114,25,81,53,97,94,119,238,196,2907,550,823,308,1469,423,1438,421,31,70,14,61,17,67,342,178,273,206
31129,3506,523,1736,323,412,206,1101,241,1037,239,64,60,7,39,57,56,51,62,172,108,1770,293,279,125,975,220,959,223,16,36,5,40,11,38,263,138,253,123
31131,12771,1924,6201,1169,1814,797,3516,804,3349,775,167,210,34,130,133,187,173,179,698,440,6570,1163,1283,698,3768,857,3578,837,190,231,77,155,113,191,800,424,719,418
31133,2189,281,1029,147,218,88,601,107,587,107,14,23,3,16,11,19,50,46,160,68,1160,179,197,91,619,118,593,113,26,28,15,22,11,23,151,58,193,78
31135,2304,226,1184,144,227,96,826,125,804,126,22,31,12,23,10,22,44,50,87,47,1120,123,125,58,744,122,730,124,14,27,2,24,12,26,156,58,95,53
31137,7332,1388,3611,808,916,528,2275,604,2199,588,76,135,14,117,62,128,55,100,365,317,3721,815,685,434,2178,572,2078,554,100,154,10,107,90,150,427,328,431,312
31139,5673,632,2812,370,717,224,1808,297,1745,295,63,84,11,58,52,79,72,85,215,139,2861,371,511,212,1816,290,1764,287,52,64,20,47,32,55,291,122,243,140
31141,25881,5141,13176,3134,4153,2193,7645,2015,7257,1931,388,534,89,327,299,493,283,461,1095,945,12705,2866,2669,1661,7764,2047,7281,1935,483,617,216,446,267,472,1299,943,973,851
31143,4247,499,2092,262,526,155,1291,214,1253,212,38,42,20,46,18,32,59,49,216,120,2155,287,451,161,1311,207,1267,203,44,62,19,46,25,48,252,111,141,84
31145,8807,2010,4348,1244,1311,826,2533,852,2381,835,152,229,60,164,92,173,108,200,396,390,4459,1150,992,657,2497,838,2326,805,171,267,71,189,100,198,572,376,398,395
31147,6565,1016,3226,585,758,353,1781,495,1678,496,103,112,27,61,76,98,137,148,550,318,3339,657,522,253,1876,530,1731,508,145,150,92,133,53,88,434,254,507,298
31149,1191,142,608,93,158,61,400,72,396,71,4,16,0,20,4,16,26,25,24,21,583,77,87,36,365,57,359,57,6,15,0,20,6,15,97,48,34,20
31151,11284,2218,5767,1368,1926,845,3187,977,3092,960,95,135,19,97,76,129,151,186,503,369,5517,1251,1490,655,2942,823,2789,801,153,191,40,117,113,199,606,392,479,339
31153,139321,25457,69163,15466,20767,10573,41745,10049,39845,9625,1900,2809,457,1739,1443,2452,1094,1991,5557,4798,70158,14835,16866,9253,41161,9762,39134,9386,2027,2863,846,2097,1181,2206,4240,3674,7891,5673
31155,16909,2521,8520,1462,2166,842,5099,1038,4919,1020,180,221,66,172,114,196,281,278,974,598,8389,1444,1530,729,5131,1040,4941,1014,190,222,97,183,93,169,801,432,927,583
31157,28555,6240,13669,3678,4114,2390,7360,2355,6869,2269,491,653,187,466,304,548,518,649,1677,1342,14886,3693,3484,2127,7626,2409,6830,2257,796,894,373,613,423,663,1799,1242,1977,1455
31159,13871,1855,7039,1170,2295,879,4044,747,3828,716,216,219,60,141,156,187,242,228,458,331,6832,1140,1642,693,4045,756,3800,724,245,263,58,121,187,218,542,341,603,396
31161,4313,713,2103,400,545,257,1255,300,1202,294,53,79,16,64,37,71,83,86,220,146,2210,406,463,207,1144,278,1083,274,61,89,19,62,42,78,329,185,274,148
31163,2515,305,1252,167,268,98,732,129,704,127,28,25,13,18,15,27,89,55,163,75,1263,184,182,76,736,131,720,131,16,23,8,21,8,24,199,111,146,68
31165,977,160,468,101,100,61,312,69,310,69,2,13,0,20,2,13,30,28,26,27,509,83,78,38,332,69,323,68,9,18,0,20,9,18,72,36,27,23
31167,4722,745,2374,420,602,244,1509,343,1433,344,76,83,24,67,52,73,79,76,184,133,2348,439,433,239,1486,324,1428,322,58,63,26,58,32,56,235,168,194,127
31169,4088,451,2041,288,489,174,1303,230,1247,221,56,61,8,22,48,67,53,45,196,119,2047,229,306,121,1276,214,1208,210,68,56,29,34,39,59,309,120,156,74
31171,537,66,242,36,48,20,175,25,170,26,5,6,0,10,5,6,4,7,15,13,295,44,47,27,175,31,174,31,1,3,0,10,1,3,40,18,33,21
31173,5001,412,2426,248,1096,197,1035,161,960,152,75,57,13,39,62,54,47,44,248,94,2575,242,948,165,1075,173,982,170,93,59,32,38,61,52,247,84,305,110
31175,3430,475,1649,270,399,170,1043,213,994,211,49,58,23,40,26,50,68,73,139,99,1781,298,313,139,1182,249,1136,237,46,77,21,64,25,59,179,99,107,67
31177,16300,3239,7942,1900,2115,1219,4988,1220,4859,1207,129,255,47,197,82,233,271,339,568,531,8358,1872,1735,1088,5187,1300,4937,1233,250,344,137,289,113,219,656,499,780,650
31179,7791,1451,3915,928,1537,670,2072,597,2026,593,46,95,7,95,39,98,75,156,231,244,3876,901,1325,530,2049,626,2006,634,43,110,30,120,13,81,291,275,211,243
31181,2856,334,1434,196,381,125,879,154,820,146,59,50,16,38,43,39,48,51,126,60,1422,194,299,125,830,136,802,138,28,37,11,34,17,34,202,78,91,48
31183,647,82,341,49,78,28,215,31,205,30,10,8,3,5,7,8,11,9,37,17,306,46,42,26,203,31,185,32,18,12,10,9,8,9,29,15,32,16
31185,11123,1730,5312,1016,1341,672,3398,739,3226,709,172,172,70,122,102,144,163,202,410,275,5811,1053,1160,590,3543,803,3250,745,293,240,92,167,201,186,622,377,486,325
32001,19567,4645,9931,2698,2628,1590,5658,1911,5084,1758,574,665,141,352,433,593,237,385,1408,967,9636,2648,1731,1237,5686,1843,5259,1790,427,521,151,355,276,443,881,741,1338,991
32003,1756110,374234,871732,224555,337078,154888,405539,127920,358681,115244,46858,50226,16108,29225,30750,40071,21739,31018,107376,75113,884378,219760,272657,135604,405777,127834,352069,113256,53708,54502,23658,35347,30050,40132,69743,56392,136201,84328
32005,41641,6612,20819,4026,5059,2526,12182,2875,11661,2825,521,775,141,499,380,669,860,912,2718,1635,20822,3906,3425,1866,12355,2895,11708,2812,647,740,188,478,459,677,2045,1352,2997,1628
32007,40356,10300,21087,6143,6344,3854,11886,4152,10608,3689,1278,1518,524,882,754,1172,443,768,2414,1894,19269,5720,4846,3290,10973,3807,10068,3498,905,1264,464,894,441,870,1403,1467,2047,1651
32009,816,173,378,83,54,38,172,55,157,52,15,22,1,16,14,19,34,32,118,56,438,124,56,55,226,74,189,66,37,33,28,33,9,13,34,26,122,65
32011,1465,355,752,221,124,88,524,164,495,157,29,44,22,48,7,12,13,30,91,91,713,194,32,35,537,169,537,169,0,26,0,26,0,26,59,80,85,65
32013,12998,3254,6797,2040,1949,1265,3861,1383,3523,1318,338,401,78,224,260,339,133,255,854,668,6201,1830,1437,986,3679,1274,3521,1258,158,283,56,207,102,250,410,355,675,524
32015,4326,1292,2336,796,551,392,1162,534,1017,480,145,208,39,111,106,162,123,173,500,381,1990,701,366,260,1211,562,1162,550,49,92,1,54,48,92,243,249,170,171
32017,4486,929,2481,657,893,459,1132,343,946,310,186,164,87,107,99,138,74,105,382,287,2005,519,340,246,1075,352,1041,342,34,78,31,77,3,32,195,166,395,304
32019,44799,8021,22668,4843,6214,2818,11860,3148,10875,3000,985,1027,443,746,542,779,849,838,3745,2164,22131,4605,5003,2599,11654,2980,10921,2897,733,854,186,490,547,740,2298,1606,3176,1837
32021,3784,761,1846,475,485,219,861,318,685,253,176,206,43,94,133,170,133,158,367,209,1938,503,581,291,824,297,705,257,119,163,51,89,68,117,267,153,266,188
32023,38211,7856,19501,4741,4846,2876,10201,3010,9078,2754,1123,1161,384,615,739,916,900,854,3554,2033,18710,4612,3427,2353,9482,2725,8512,2586,970,1119,457,760,513,732,2362,1564,3439,2137
32027,5658,1074,3863,728,1345,423,1575,572,1153,506,422,241,107,124,315,217,163,174,780,330,1795,568,247,214,1070,434,992,413,78,110,35,76,43,96,150,134,328,238
32029,3398,629,1811,422,479,259,946,283,905,276,41,47,17,36,24,36,46,62,340,246,1587,354,289,191,931,262,877,265,54,88,21,45,33,78,136,104,231,146
32031,373764,77759,187473,47971,65030,32761,94737,28969,86616,27003,8121,9905,3407,6815,4714,7497,4570,6945,23136,16805,186291,44969,50782,27098,93862,28308,85497,26223,8365,10049,3635,6713,4730,7661,13853,11831,27794,17966
32033,8055,1769,4837,1169,1891,699,2059,740,1771,710,288,201,51,130,237,202,146,170,741,453,3218,860,536,353,1772,601,1671,600,101,184,28,149,73,162,326,290,584,361
32510,45496,9481,23372,5954,7627,3832,11806,4003,10707,3726,1099,1206,436,814,663,933,837,983,3102,2172,22124,5254,5124,3131,10679,3478,9730,3310,949,1233,455,845,494,895,2526,1850,3795,2278
33001,51645,12125,25372,7236,7238,4526,14257,4461,13449,4184,808,1201,359,897,449,844,928,1113,2949,2322,26273,6753,6031,4032,14080,4301,13337,4170,743,1127,312,831,431,835,2463,1909,3699,2686
33003,41957,9906,20635,5830,5093,3304,11958,3970,11326,3834,632,945,239,691,393,667,672,912,2912,2253,21322,5667,3991,2835,12230,3938,11576,3851,654,1024,255,675,399,790,2169,1796,2932,2183
33005,64792,12895,31450,7711,10983,5121,15444,4419,14788,4347,656,1030,276,799,380,846,1116,1482,3907,2806,33342,7563,9863,4705,16096,4737,15326,4537,770,1223,386,958,384,920,2841,2236,4542,2873
33007,27549,5373,14592,3302,4567,2056,7290,2069,6714,1955,576,540,186,364,390,507,458,511,2277,1413,12957,2931,2763,1648,6771,1940,6443,1883,328,471,154,422,174,397,1470,916,1953,1217
33009,77805,15686,38084,9126,14613,6644,18887,5449,17476,5164,1411,1821,382,1062,1029,1532,1012,1400,3572,2594,39721,9607,12484,6377,18520,5596,17119,5123,1401,1884,425,1093,976,1548,3549,2836,5168,3403
33011,343278,68252,169669,41039,57466,28132,90943,25544,85044,24166,5899,7726,2235,5015,3664,5952,4026,5940,17234,13525,173609,39972,46992,24298,89885,25300,84087,23838,5798,7606,2644,5204,3154,5527,14172,11296,22560,15279
33013,126429,22158,61943,13450,20281,9146,33250,8251,31461,7970,1789,2100,620,1552,1169,1640,1628,2056,6784,4749,64486,13212,15668,7764,34256,8472,32617,8210,1639,2216,514,1406,1125,1914,5241,3821,9321,5508
33015,258121,44697,127101,26839,37994,18066,74027,17362,70472,16673,3555,4688,1317,3112,2238,3774,3136,4156,11944,8994,131020,26193,31508,16399,73255,17129,70094,16645,3161,4317,1451,3133,1710,3244,10460,8088,15797,9932
33017,109267,21198,53080,12716,20062,8837,26622,7848,25268,7500,1354,2016,474,1287,880,1605,1092,1726,5304,4246,56187,12617,19026,8068,26303,7763,24908,7366,1395,2051,581,1397,814,1553,3833,3292,7025,4851
33019,36511,8545,18090,5088,5524,3277,9380,3063,8834,2879,546,852,261,624,285,608,504,712,2682,2048,18421,4878,4301,2627,9227,3088,8646,2863,581,834,383,771,198,498,2232,1732,2661,1985
34001,219253,48842,104961,28694,39115,19651,52575,16811,47952,15578,4623,5651,1812,3553,2811,4475,3089,4123,10182,8413,114292,29748,36660,18809,51911,16510,46264,14966,5647,6295,2737,4337,2910,4514,11612,8549,14109,9808
34003,768719,200725,368750,114737,120639,72299,216724,72817,202956,68947,13768,20016,3796,12687,9972,17076,8621,15547,22766,25850,399969,115299,110354,67665,213576,70608,197987,66347,15589,21210,6064,14272,9525,16936,37689,32289,38350,33839
34005,369266,65477,180384,41020,62667,29179,98921,23953,91678,22391,7243,7806,2841,5255,4402,6040,4619,6095,14177,11368,188882,37729,52932,24567,96529,23180,89412,21765,7117,8194,3470,5820,3647,5933,17519,11672,21902,13573
34007,410888,95415,195621,56703,79069,41152,95966,31683,87174,28811,8792,11429,3896,7714,4896,8660,5271,8115,15315,14570,215267,56416,74443,38051,97066,31514,85319,27753,11747,13288,6131,9460,5616,9225,20082,15658,23676,17831
34009,79666,17635,38577,10154,11427,6220,22525,6829,21267,6527,1258,1760,458,1320,800,1496,1588,1860,3037,2758,41089,9885,9131,5410,22857,6766,21559,6571,1298,1767,572,1429,726,1335,4731,3177,4370,3264
34011,121649,28866,62352,17500,28799,12264,25764,9547,21690,8475,4074,3433,1473,2144,2601,2612,1866,2388,5923,4634,59297,16027,20982,10178,25455,9438,22050,8495,3405,3701,1860,2677,1545,2478,5434,4117,7426,5534
34013,637052,171338,301711,101358,134960,72693,138902,55056,119690,48881,19212,22500,7666,14353,11546,17378,7421,13596,20428,22802,335341,102117,138419,70734,136580,53165,114732,46296,21848,23789,11609,16942,10239,16511,28104,24983,32238,28140
34015,238870,45778,114791,26797,40965,18734,62082,15900,58288,15057,3794,5219,1696,3671,2098,3963,3235,4448,8509,7441,124079,27733,36748,18208,62233,15725,57628,14848,4605,5551,2213,3927,2392,4111,11402,8043,13696,9623
34017,552057,127895,273110,77838,119834,56242,130410,46606,112949,42174,17461,18066,5251,9759,12210,14645,5227,9169,17639,17597,278947,74173,104021,49014,125559,44383,106457,39738,19102,18578,9438,12556,9664,12833,20991,18413,28376,22531
34019,105713,17043,52364,10151,16244,7001,31474,6725,30377,6557,1097,1611,356,1102,741,1434,1206,1625,3440,2849,53349,10140,12982,6365,31141,6630,30014,6518,1127,1705,677,1392,450,1190,4070,3182,5156,3362
34021,303257,73622,146718,44070,59795,30805,74373,24340,66846,21797,7527,9212,3095,5922,4432,6766,3234,5263,9316,9623,156539,42112,55334,28082,72764,23417,64973,20955,7791,9032,3801,6112,3990,6339,13433,10908,15008,11693
34023,676668,144290,331035,84367,120433,56445,185557,52358,171715,48837,13842,16355,3363,9179,10479,14098,8026,11890,17019,17491,345633,82819,103411,50866,181495,50758,166867,47083,14628,16945,5528,10468,9100,13403,30992,22807,29735,23609
34025,514685,109957,247857,65418,83279,44063,140901,39611,133648,37953,7253,10947,2244,7332,5009,9320,6411,9772,17266,16541,266828,63626,74897,39828,140481,39205,132151,37381,8330,11550,3798,8554,4532,8845,25389,18683,26061,19939
34027,408709,75004,198656,45230,63071,30819,118441,28524,112091,27201,6350,8042,1990,5209,4360,6705,4809,6858,12335,11329,210053,43672,56011,27441,115392,27287,109008,26232,6384,8066,2770,5742,3614,6043,18089,12930,20561,14565
34029,476324,92050,226212,53948,69898,35199,129448,34578,122145,32902,7303,9767,2462,6582,4841,7891,9006,9686,17860,15178,250112,54443,60797,31977,129489,34279,121871,32680,7618,10092,3267,7124,4351,7683,31850,19211,27976,18933
34031,403242,107523,194088,62802,80425,42831,97067,35727,86114,32288,10953,12982,3882,7655,7071,10311,4014,7581,12582,13606,209154,61505,76274,39638,94030,33873,81571,30230,12459,13357,5733,8786,6726,9931,18140,15410,20710,17456
34033,51825,9027,25129,5599,8643,3824,13212,3463,12005,3198,1207,1284,467,819,740,1062,902,1007,2372,1694,26696,5362,7638,3494,13161,3387,11911,3143,1250,1259,691,962,559,898,2964,1899,2933,1919
34035,270990,50557,130898,29846,42252,20412,78476,19234,73912,18075,4564,5667,1269,3214,3295,4745,2774,3956,7396,7031,140092,29941,39228,19478,76852,18101,72187,17261,4665,5441,1961,3589,2704,4220,11313,8112,12699,9254
34037,118970,22684,58838,13402,18518,8969,34070,8508,32281,8226,1789,2406,888,1853,901,1819,1513,2083,4737,3765,60132,13110,14647,8020,33845,8414,32101,8108,1744,2382,875,1865,869,1767,4868,3614,6772,4464
34039,445770,116826,215167,68166,84362,45856,111327,39761,100617,36309,10710,13434,4004,8350,6706,10630,5983,9490,13495,14893,230603,66825,79949,43163,107149,37520,96613,34514,10536,13096,4639,8791,5897,10050,21249,18128,22256,18583
34041,88986,16891,43353,10332,14167,6769,23747,6119,22251,5936,1496,1918,682,1396,814,1479,1317,1750,4122,3256,45633,9870,12507,6282,23576,6170,21987,5911,1589,1910,730,1377,859,1528,4694,3337,4856,3484
35001,554117,123603,268954,76243,107926,54938,121323,41677,110286,37876,11037,14707,3419,8348,7618,11915,7497,10681,32208,25807,285163,74261,94454,48976,121325,40803,108896,37329,12429,15260,5121,9684,7308,11731,24129,19940,45255,29192
35003,3148,838,1782,567,537,360,891,343,777,325,114,113,16,51,98,106,126,120,228,201,1366,400,326,316,700,282,601,241,99,117,10,40,89,117,221,220,119,103
35005,50909,13945,25183,8281,8972,5343,11917,4595,10663,4199,1254,1570,556,1085,698,1135,726,1094,3568,2954,25726,8003,7309,4868,12389,4728,11158,4430,1231,1533,613,1120,618,1097,2458,2139,3570,2654
35006,21633,4904,10987,3134,4186,2040,4689,1958,3900,1682,789,821,290,465,499,597,472,623,1640,1186,10646,2836,3852,1836,4137,1664,3469,1539,668,612,271,374,397,494,1201,935,1456,978
35007,10310,2742,5295,1818,1505,1022,2717,1111,2434,1019,283,363,34,201,249,344,288,396,785,637,5015,1686,1060,849,2427,1004,2261,963,166,279,83,244,83,193,784,706,744,606
35009,38460,9960,20091,6422,7745,4386,9076,3619,8361,3412,715,990,215,636,500,822,537,804,2733,2189,18369,5505,5618,3403,8854,3260,7848,3049,1006,1308,290,695,716,1109,1607,1424,2290,1862
35011,1525,382,802,260,313,165,329,133,275,109,54,66,23,48,31,52,81,67,79,54,723,228,281,164,259,86,232,83,27,31,7,23,20,25,142,99,41,33
35013,171446,42639,83467,25558,33129,17764,41176,14430,37638,13478,3538,4307,1380,2838,2158,3198,2104,3303,7058,6518,87979,25318,29173,16396,41473,14534,36596,13263,4877,5477,2564,3742,2313,3635,6678,6107,10655,7954
35015,44928,13598,22520,7950,6885,4499,12117,5184,10932,4710,1185,1595,506,1030,679,1101,682,1010,2836,2655,22408,7566,5924,4297,11608,4706,10686,4552,922,1259,537,991,385,827,2086,1918,2790,2510
35017,23086,5944,11229,3552,3948,2591,5270,2147,4972,2033,298,531,59,352,239,516,583,717,1428,1132,11857,3595,3074,2131,5141,2114,4806,1976,335,544,159,403,176,430,1530,1126,2112,1530
35019,3634,901,2118,622,942,392,582,258,403,203,179,157,106,144,73,64,117,112,477,282,1516,561,534,341,462,225,458,223,4,44,4,44,0,48,271,200,249,239
35021,389,63,237,40,50,20,114,24,110,24,4,5,4,5,0,12,29,14,44,20,152,43,26,24,106,31,82,19,24,22,16,22,8,7,11,8,9,6
35023,3492,386,1749,227,479,207,951,173,776,172,175,102,56,65,119,91,75,62,244,124,1743,235,452,175,862,178,784,178,78,73,40,60,38,42,262,112,167,98
35025,52440,14956,27030,8955,9466,5473,14238,5482,12167,4745,2071,2346,553,1145,1518,2006,592,1118,2734,2547,25410,8257,7069,4604,13209,4962,11825,4611,1384,1817,747,1323,637,1271,2298,2342,2834,2569
35027,16487,4829,7990,2936,1891,1402,4201,1559,3835,1459,366,504,253,419,113,244,555,721,1343,1274,8497,2760,1312,1254,4913,1811,4370,1625,543,702,201,424,342,503,877,860,1395,1041
35028,15116,2811,7597,1695,2068,1145,4682,1278,4362,1222,320,440,0,204,320,440,170,298,677,615,7519,1821,1511,1036,4531,1250,4371,1221,160,309,15,205,145,306,474,515,1003,840
35029,18716,4711,9308,2931,3034,1815,4549,1714,4045,1535,504,558,213,397,291,409,342,432,1383,959,9408,2585,2303,1420,4417,1706,3750,1379,667,798,306,514,361,497,1145,865,1543,1060
35031,54886,12210,26048,7056,13155,4777,10296,3730,8461,3265,1835,1430,685,823,1150,1091,797,838,1800,1616,28838,6984,13023,4750,10079,3526,8270,3097,1809,1555,696,871,1113,1171,3141,1989,2595,1818
35033,4117,1323,1952,846,825,574,760,376,644,339,116,162,109,151,7,61,35,88,332,349,2165,812,869,563,644,384,592,359,52,104,48,119,4,45,243,250,409,371
35035,53066,13064,27453,8330,10081,5713,12937,4424,11273,4117,1664,1433,364,818,1300,1263,1044,1382,3391,2726,25613,7341,6195,3960,12989,4645,11571,4228,1418,1705,514,1005,904,1405,2473,2126,3956,3098
35037,6680,2202,3228,1306,1269,896,1364,647,1184,569,180,274,100,230,80,191,232,287,363,353,3452,1344,923,778,1329,699,1157,575,172,306,84,235,88,205,596,469,604,473
35039,31506,8812,15370,4993,6797,3313,6095,2474,5286,2210,809,828,144,384,665,766,380,494,2098,1780,16136,5488,7025,3957,5647,2360,4941,2130,706,848,258,539,448,663,1566,1253,1898,1352
35041,15005,3905,7402,2428,3128,1685,3195,1314,2916,1242,279,367,149,292,130,251,340,434,739,695,7603,2285,2573,1448,3280,1346,3124,1306,156,302,43,234,113,272,860,757,890,772
35043,115167,21996,55847,13093,18274,8508,29398,7601,27849,7332,1549,1818,676,1318,873,1361,1273,1623,6902,4565,59320,12351,16461,7530,29810,7518,28058,7245,1752,1961,757,1367,995,1488,4643,3082,8406,4842
35045,98229,22966,48187,13472,18513,9020,23524,8142,21579,7729,1945,2327,823,1681,1122,1763,1351,1908,4799,3945,50042,13624,16774,8187,23125,7981,20428,7264,2697,2886,1060,1840,1637,2139,4248,3444,5895,4265
35047,23562,6578,11662,3889,5569,2687,4259,2066,3654,1903,605,810,410,698,195,447,390,579,1444,1126,11900,4027,4365,2700,4226,2052,3707,1916,519,734,343,628,176,441,1279,1136,2030,1478
35049,126817,22999,61080,13792,21570,9494,29933,8601,27247,7993,2686,2897,818,1669,1868,2470,1563,2201,8014,5141,65737,14054,18894,8744,29141,8243,27121,7950,2020,2447,916,1736,1104,1872,5301,3959,12401,6426
35051,9562,1961,4766,1244,1466,764,2034,762,1781,697,253,335,64,136,189,292,376,302,890,555,4796,1148,897,526,2109,768,1970,767,139,186,54,126,85,152,693,512,1097,594
35053,13632,3804,7024,2487,3846,2061,2118,983,1756,821,362,469,125,225,237,389,238,302,822,711,6608,2381,2605,1684,2616,1361,2042,1059,574,694,65,200,509,666,592,500,795,656
35055,27920,7454,13683,4616,5560,3156,5312,2230,4963,2103,349,536,100,295,249,477,448,624,2363,1682,14237,4376,4395,2680,5885,2412,4860,2055,1025,1200,253,470,772,1016,1394,1184,2563,1732
35057,12874,3340,6963,2169,2523,1377,3426,1192,3036,1148,390,395,71,181,319,346,316,413,698,541,5911,1767,1289,827,2876,1105,2473,979,403,490,112,217,291,417,827,607,919,651
35059,3372,519,1907,395,817,281,687,207,533,177,154,108,26,50,128,97,94,75,309,128,1465,247,376,139,672,198,534,172,138,126,87,105,51,56,198,120,219,124
35061,61206,17153,30507,9742,10240,6084,15109,5697,13856,5267,1253,1681,411,969,842,1322,1059,1568,4099,3187,30699,9822,8638,5870,14195,5276,13228,5030,967,1402,415,885,552,1109,3208,2653,4658,3543
36001,260318,55753,124712,33864,55589,26354,55617,18403,50773,16908,4844,6301,1957,4262,2887,4935,3333,4927,10173,9105,135606,34559,52380,25183,56171,18800,50975,17225,5196,6591,2184,4471,3012,5057,12170,9261,14885,11177
36003,38954,5429,19656,3278,7207,2236,9737,2126,9067,2016,670,661,375,536,295,487,770,653,1942,1135,19298,3287,5666,1938,9599,2065,8799,1978,800,707,433,534,367,546,1863,1068,2170,1159
36005,1134602,341893,523346,202076,266647,144649,206503,108057,152972,88103,53531,55759,19309,30781,34222,42868,11652,23526,38544,43160,611256,203118,282832,141530,212539,104018,141718,80924,70821,61626,37119,41328,33702,41773,48776,46896,67109,57233
36007,162375,38434,79109,23832,32380,17527,37043,13028,34194,12315,2849,4181,1432,3410,1417,3228,2171,3622,7515,6944,83266,22849,28039,15424,37051,12956,33431,12117,3620,4822,2070,3905,1550,3465,8333,6679,9843,7715
36009,62970,11262,31109,6660,10702,4409,15922,4238,14590,3915,1332,1496,606,1051,726,1206,1120,1212,3365,2187,31861,6710,8551,4032,15947,4108,14511,3853,1436,1534,737,1162,699,1176,3177,2032,4186,2517
36011,64926,11942,33241,7551,12280,5399,16039,4384,13969,3950,2070,1628,823,1227,1247,1175,1147,1319,3775,2586,31685,6849,8569,4378,15843,4353,14285,4020,1558,1679,869,1281,689,1179,3326,2208,3947,2528
36013,106994,21036,52496,12707,18909,8807,26271,7732,24039,7180,2232,2768,1359,2337,873,1756,1569,2121,5747,4206,54498,12436,15681,7780,25705,7564,23617,7068,2088,2636,1272,2132,816,1831,6198,4068,6914,4773
36015,69797,15878,34435,9767,12342,6501,17675,5980,15679,5562,1996,2129,861,1585,1135,1592,1077,1590,3341,2874,35362,9084,10021,5704,17471,5851,15622,5445,1849,2271,1195,1925,654,1382,3448,2688,4422,3208
36017,39776,7730,19840,4643,5933,2935,10658,2973,9760,2806,898,937,474,706,424,678,697,854,2552,1723,19936,4313,4580,2420,10796,3019,9714,2807,1082,1156,663,890,419,736,2222,1425,2338,1477
36019,68527,14965,35179,8992,14296,6424,16110,5299,14061,4899,2049,1850,758,1364,1291,1364,1159,1646,3614,2974,33348,8880,10170,5554,15729,5429,14554,5154,1175,1642,620,1321,555,1223,3396,2704,4053,3175
36021,51968,10885,25891,6447,8777,4350,13784,4300,12249,3913,1535,1669,708,1153,827,1207,777,1007,2553,1977,26077,6391,7063,4068,13068,4020,12064,3867,1004,1205,607,1037,397,850,2891,2106,3055,2122
36023,40352,8570,19513,5183,8118,3965,9231,2753,8501,2621,730,858,433,726,297,645,418,623,1746,1369,20839,5265,8080,3821,9255,2765,8557,2616,698,902,424,764,274,657,1657,1373,1847,1409
36025,38858,9119,19553,5619,6922,3782,9796,3407,8827,3173,969,1164,425,838,544,906,787,935,2048,1623,19305,5198,4811,2745,9810,3417,8901,3240,909,1025,564,876,345,774,2308,1725,2376,1739
36027,248888,56684,123164,33640,45763,23096,64544,19919,57525,18180,7019,7247,2644,4855,4375,5528,3308,5051,9549,8742,125724,32731,38725,20555,62718,19290,56956,17822,5762,7011,2763,4994,2999,5068,11158,9002,13123,10159
36029,765893,163072,366733,99626,145048,72734,178053,58123,165655,54459,12398,18155,5768,13862,6630,13773,11128,16406,32504,28979,399160,99402,135354,70073,176371,57112,162096,53199,14275,19080,7754,14982,6521,13854,41258,30872,46177,33787
36031,32573,6963,16999,4302,5911,2785,8690,2764,7537,2450,1153,1047,507,764,646,723,713,809,1685,1249,15574,3825,3540,2084,8111,2502,7623,2417,488,672,278,555,210,518,2012,1439,1911,1450
36033,42192,7662,23307,4830,9977,3353,10655,3129,9133,2941,1522,943,488,657,1034,740,534,608,2141,1488,18885,4121,4936,2316,9444,2715,8607,2507,837,939,450,767,387,652,1850,1374,2655,1646
36035,44714,10888,22148,6471,7729,4478,11074,3983,9905,3759,1169,1400,652,1143,517,925,808,1137,2537,2075,22566,6135,5929,3632,11217,4038,10037,3838,1180,1413,731,1101,449,932,2623,2129,2797,2104
36037,48161,9364,24096,5640,8100,3894,12646,3492,11709,3310,937,1238,422,916,515,947,713,956,2637,2085,24065,5528,6252,3516,12484,3457,11560,3282,924,1187,529,912,395,899,2501,1790,2828,2084
36039,41010,10193,21445,6370,8846,4424,9612,3371,8332,2997,1280,1281,360,732,920,1083,822,1086,2165,1878,19565,5619,5646,3430,9555,3423,8517,3099,1038,1305,334,712,704,1150,2240,1830,2124,1823
36041,4024,966,2014,566,720,359,870,295,700,227,170,159,97,100,73,118,309,180,115,108,2010,662,441,227,778,305,618,223,160,191,120,178,40,99,384,322,407,345
36043,51528,10899,25318,6482,8533,4399,13307,3974,12298,3724,1009,1358,491,1011,518,1036,725,922,2753,2127,26210,6249,6606,3770,13294,3945,12283,3759,1011,1248,679,1075,332,882,3032,2090,3278,2331
36045,89439,19925,47330,12670,17504,8674,24788,7471,22174,6861,2614,2771,1031,1776,1583,2141,1003,1519,4035,3170,42109,10281,9837,5862,23974,6937,21668,6600,2306,2382,1197,1753,1109,1640,3428,2683,4870,3388
36047,2083672,513811,967861,302076,441447,212188,454572,175793,388764,156548,65808,69558,20579,40351,45229,56673,20514,38574,51328,58226,1115811,305168,467298,210114,463195,172351,375314,150011,87881,78543,40160,52672,47721,56172,90015,76124,95303,78675
36049,21506,3515,10763,1919,3181,1210,6036,1265,5728,1226,308,358,118,261,190,315,403,377,1143,645,10743,2037,2684,1328,6063,1271,5705,1209,358,361,211,298,147,261,1003,644,993,615
36051,54393,8769,27269,5485,9908,4101,13786,3359,12374,3188,1412,1018,563,716,849,784,756,913,2819,1861,27124,5410,8536,3733,12715,3243,11830,3034,885,1057,561,854,324,657,2545,1706,3328,2017
36053,60091,10386,29454,6305,11206,4588,14687,3734,13712,3591,975,1150,613,908,362,758,944,1048,2617,2008,30637,6235,9327,3903,14908,3840,13720,3592,1188,1345,680,1022,508,904,2784,1923,3618,2364
36055,615221,124194,293440,76547,117214,56454,141500,43120,130484,39976,11016,14784,5167,10796,5849,11429,8203,12577,26523,23030,321781,76044,113195,54722,142123,42819,128364,39157,13759,16674,7593,12763,6166,11501,28333,21594,38130,26836
36057,40033,7548,19570,4590,6999,3296,9763,2754,8905,2600,858,937,490,735,368,641,724,820,2084,1481,20463,4304,5988,2804,9578,2681,8566,2546,1012,1023,661,838,351,630,2553,1465,2344,1539
36059,1117182,289310,537407,163604,184702,103601,310934,98999,289576,92745,21358,28855,5590,17941,15768,25077,14020,22779,27751,32461,579775,164359,170463,97883,306487,96578,280408,89119,26079,32189,10130,21518,15949,24950,55390,43895,47435,42284
36061,1430818,384445,670837,242515,341409,179265,270203,138154,227867,121998,42336,52116,13490,27878,28846,42137,13691,27872,45534,54093,759981,240793,365005,178006,266046,131348,215429,114292,50617,54870,21872,33093,28745,40814,52626,55503,76304,71007
36063,176111,34857,85161,20688,30082,14931,43483,12770,40520,12138,2963,4049,1405,3049,1558,3109,2829,3784,8767,6677,90950,21120,26151,14138,43878,12986,40388,12220,3490,4477,1834,3245,1656,3354,9657,6787,11264,7747
36065,189503,37444,93955,22622,36843,16168,44808,13373,40604,12325,4204,4654,1701,3323,2503,3534,3172,3989,9132,7021,95548,22017,28949,14259,44979,13330,40711,12293,4268,5015,2593,4109,1675,3126,10546,7397,11074,7641
36067,381623,73700,181706,44840,71591,32600,89182,26227,82478,24586,6704,8695,3105,6372,3599,6822,5381,7641,15552,12894,199917,45372,67720,30559,90168,26471,81635,24378,8533,10012,4593,7597,3940,6857,18004,13319,24025,16496
36069,91388,16197,44431,9664,14405,6407,23919,6197,22436,5903,1483,1855,945,1553,538,1208,1493,1947,4614,3413,46957,9682,13062,6435,23561,6013,22045,5745,1516,1833,951,1521,565,1235,4550,2951,5784,3547
36071,300231,74606,149367,43533,57607,29634,78149,25611,71821,24037,6328,7920,2243,5063,4085,6365,3531,5622,10080,9833,150864,42348,47387,26593,76529,24634,69506,22919,7023,8445,3387,5908,3636,6129,12528,10415,14420,11617
36073,34483,5607,17135,3397,5802,2396,8941,2277,8100,2190,841,733,360,581,481,540,425,533,1967,1316,17348,3390,4358,2118,8927,2275,7934,2149,993,860,596,783,397,409,1505,1024,2558,1411
36075,97780,16448,48659,10251,17387,7308,24391,6329,22123,5946,2268,2307,1395,1905,873,1425,1542,1770,5339,3687,49121,9553,14244,6172,24717,6458,22398,6056,2319,2482,1543,1963,776,1461,4592,3223,5568,3703
36077,52093,9935,24866,5834,9140,4019,12466,3452,11466,3225,1000,1164,519,840,481,882,816,969,2444,1714,27227,6065,9324,4023,12350,3370,11312,3212,1038,1064,614,882,424,738,2822,1912,2731,1905
36079,83075,19962,41267,11388,13641,7350,24100,6927,21625,6426,2475,2397,706,1365,1769,1906,893,1399,2633,2591,41808,11630,10750,6467,23522,7000,21602,6477,1920,2131,702,1370,1218,1666,3498,3064,4038,3275
36081,1897557,471250,909811,274339,368437,178920,467803,168184,393267,145800,74536,72227,17445,34136,57091,61992,21628,36146,51943,55487,987746,274043,346351,170058,458937,161387,377829,139553,81108,73861,29278,42440,51830,57092,93286,74370,89172,72868
36083,133635,27784,65644,16939,26777,12156,31382,9940,28511,9144,2871,3446,1534,2714,1337,2264,2273,2938,5212,4709,67991,16438,22724,11004,31241,9921,28408,9171,2833,3546,1733,2869,1100,2152,6281,4745,7745,5834
36085,389229,91828,186176,52862,64593,33641,105848,33638,97016,31194,8832,10261,2351,5900,6481,8747,5124,7453,10611,11194,203053,52545,63040,32528,103915,32157,94208,30050,9707,10736,4525,7416,5182,7869,19265,14940,16833,14053
36087,248653,57666,120530,33542,42734,22721,68120,19475,62635,18004,5485,6275,1553,3500,3932,5337,3122,4480,6554,6755,128123,32620,38236,20407,68338,19413,62346,17920,5992,6674,2543,4311,3449,5062,10745,8456,10804,8433
36089,90589,18759,45883,11282,18142,7988,21709,6810,19577,6371,2132,2270,1001,1712,1131,1669,1326,1850,4706,3630,44706,10872,13965,6749,21414,6642,19608,6329,1806,2242,1105,1876,701,1489,4390,3306,4937,3826
36091,190756,32568,93707,19484,29170,13461,54258,12822,51465,12431,2793,3655,1323,2553,1470,2765,2500,3298,7779,6005,97049,19137,23484,11902,54166,12746,50937,12206,3229,3803,1645,2780,1584,2775,7907,5922,11492,7401
36093,127246,34950,61243,20284,25036,13936,28018,10420,24961,9306,3057,4127,1391,2853,1666,3099,2293,3295,5896,5484,66003,21087,22560,13491,28438,10750,24882,9278,3556,4557,1653,2964,1903,3387,6541,5525,8464,6852
36095,26757,4855,13228,2914,4625,1959,6758,1777,6048,1648,710,686,325,475,385,513,394,463,1451,937,13529,2787,3751,1660,6523,1701,6013,1623,510,560,303,461,207,428,1423,875,1832,1158
36097,15143,2825,7523,1697,2280,1005,4034,1082,3777,1044,257,304,158,247,99,259,271,319,938,654,7620,1613,1927,998,3852,1062,3547,1006,305,340,210,286,95,254,787,510,1054,705
36099,28760,5012,15033,3156,5280,2167,7698,2024,6682,1881,1016,620,319,504,697,533,519,623,1536,1046,13727,2813,3541,1803,7072,1933,6598,1830,474,614,226,489,248,489,1241,790,1873,1202
36101,79351,13478,39293,8092,11949,5187,21256,5253,19558,4901,1698,1764,953,1319,745,1343,1176,1376,4912,3105,40058,7883,9829,4763,21304,5156,19570,4884,1734,1771,1180,1527,554,1186,3974,2577,4951,3004
36103,1226351,295527,598954,170826,216239,110987,324025,98538,295693,90813,28332,33072,7688,18067,20644,28199,17040,23510,41650,39890,627397,165628,187055,99245,318241,95744,286812,87280,31429,35064,11636,21124,19793,27452,59835,45665,62266,47561
36105,62009,17584,31722,10610,12151,6869,15084,5931,13156,5428,1928,2006,634,1376,1294,1571,1014,1583,3473,3159,30287,9928,9182,6116,14674,5766,12937,5317,1737,2120,957,1645,780,1449,2979,2611,3452,2935
36107,40381,8568,19889,5037,5882,3319,11733,3377,11112,3248,621,887,310,722,311,681,609,868,1665,1359,20492,4869,4532,2771,11570,3288,10680,3164,890,992,503,798,387,709,2001,1571,2389,1808
36109,90171,16034,44170,10506,23132,8736,17639,5326,16300,5049,1339,1639,374,998,965,1400,860,1319,2539,2269,46001,10320,21377,8161,17685,5312,16303,5108,1382,1614,708,1253,674,1168,2660,2071,4279,2838
36111,152707,35344,75479,21085,28092,14335,36845,12762,31882,11705,4963,4438,1438,2887,3525,3477,2328,3428,8214,6682,77228,20768,23330,12604,36934,12820,32775,11900,4159,4429,1553,2974,2606,3348,7488,6392,9476,7335
36113,54748,9540,26710,5837,8721,3985,13981,3616,13006,3433,975,1182,424,807,551,892,1002,1141,3006,2223,28038,5605,6936,3290,14328,3698,13300,3509,1028,1169,557,887,471,844,2859,1925,3915,2284
36115,52007,9261,26883,5670,9876,3903,13251,3521,11902,3339,1349,1048,324,642,1025,921,812,965,2944,1968,25124,5347,6302,3265,12865,3372,11874,3239,991,1055,643,889,348,668,2558,1706,3399,2134
36117,74507,12514,36715,7271,11005,4958,20345,4789,19192,4542,1153,1380,539,991,614,1068,1030,1250,4335,2813,37792,7621,9398,4946,20389,4827,18775,4486,1614,1756,1004,1393,610,1105,3415,2249,4590,2744
36119,793490,192017,378805,111973,136288,73906,209280,67583,188678,61392,20602,24093,6314,13828,14288,19728,9423,14915,23814,25082,414685,112151,134381,71406,203210,64169,181675,58441,21535,24137,9972,16228,11563,17272,35382,29124,41712,33580
36121,33782,6185,18273,3916,6457,2601,9247,2496,8205,2337,1042,813,353,588,689,660,574,700,1995,1308,15509,3410,3699,1988,8581,2347,8052,2268,529,727,325,636,204,571,1239,914,1990,1364
36123,20442,3870,9747,2279,3252,1649,5287,1282,4914,1192,373,466,127,258,246,414,270,311,938,678,10695,2177,2977,1360,5787,1465,5183,1281,604,624,400,522,204,340,957,594,974,638
37001,133298,28052,62138,16868,21030,11791,32778,9823,30585,9360,2193,2910,1037,2120,1156,2137,2054,2702,6276,5201,71160,17215,21757,10989,33361,10004,29647,8992,3714,4105,2334,3212,1380,2439,7459,5255,8583,5936
37003,31039,7270,15820,4205,4551,2405,8944,2758,8070,2567,874,857,380,566,494,650,596,707,1729,1360,15219,4149,3361,2137,8291,2528,7536,2377,755,903,434,661,321,566,1835,1417,1732,1389
37005,9442,2174,4650,1217,1095,685,2868,893,2689,863,179,230,78,172,101,180,219,219,468,404,4792,1205,693,459,2978,956,2716,912,262,294,193,262,69,158,525,378,596,476
37007,20962,5394,11102,3362,4787,2529,4521,1830,3712,1573,809,818,363,505,446,564,590,620,1204,886,9860,3116,2924,1874,4411,1799,3799,1622,612,689,386,542,226,405,1200,895,1325,987
37009,22949,5437,11176,3165,3017,1996,6688,2161,6271,2088,417,561,144,382,273,457,330,454,1141,931,11773,3171,2024,1555,6967,2233,6255,2082,712,782,423,578,289,503,1546,1189,1236,984
37011,15437,3669,8557,2290,2960,1466,3929,1286,3158,1141,771,488,250,285,521,401,356,360,1312,644,6880,2079,1467,1119,3985,1304,3618,1229,367,421,203,331,164,283,715,526,713,638
37013,39375,9434,18519,5490,5684,3488,10012,3259,9374,3115,638,878,366,703,272,576,991,1064,1832,1661,20856,5657,4840,3259,10699,3509,9556,3172,1143,1307,780,1013,363,746,2567,1698,2750,2009
37015,16593,4810,8370,2747,3388,1805,3643,1553,3093,1388,550,592,361,532,189,343,417,535,922,861,8223,2791,2184,1491,3307,1378,2815,1224,492,605,321,469,171,358,1391,1141,1341,984
37017,27674,8829,13009,4950,4032,2921,6786,3084,6089,2916,697,980,395,697,302,660,660,877,1531,1515,14665,5287,4294,3299,6687,3037,5738,2689,949,1203,639,936,310,648,1950,1477,1734,1541
37019,114787,21485,54639,12595,11916,7117,35761,8852,32933,8097,2828,3271,1085,1966,1743,2457,1701,2167,5261,4244,60148,12617,10746,6834,36194,8642,33362,8000,2832,3178,1572,2417,1260,2025,6040,4058,7168,4808
37021,217183,46376,102886,27529,34299,17885,54628,17219,51148,16424,3480,4636,1380,3011,2100,3637,2989,4016,10970,9082,114297,27873,32471,17237,55144,16996,50887,16286,4257,5130,2120,3663,2137,3516,10530,7901,16152,10511
37023,76286,17122,37935,10273,12928,6680,19653,6014,17734,5458,1919,2203,980,1559,939,1430,1354,1657,4000,3239,38351,9599,8704,5465,20817,6382,18548,5721,2269,2530,1252,1762,1017,1638,4411,3116,4419,3327
37025,162796,31191,78176,18699,24077,12448,45638,11341,42680,10597,2958,3661,1354,2376,1604,2622,2001,2733,6460,5546,84620,18494,23120,11897,44529,10733,40552,10064,3977,4185,2148,2902,1829,2718,6553,4935,10418,6821
37027,68466,17094,33549,9557,9758,5863,18818,6359,17251,5900,1567,1945,771,1332,796,1403,1121,1564,3852,3185,34917,9794,7355,4946,18614,6263,16646,5755,1968,2246,1304,1862,664,1253,4180,3167,4768,3459
37029,8558,1479,4430,968,1169,650,2788,612,2685,613,103,137,61,113,42,94,120,161,353,325,4128,820,564,357,2578,641,2351,575,227,255,85,153,142,199,372,353,614,401
37031,59088,10685,28651,6470,7431,3920,16780,4309,15595,4145,1185,1453,553,1103,632,1187,1085,1266,3355,2379,30437,6306,5702,3486,16667,4253,15288,4020,1379,1546,854,1307,525,1044,3663,2388,4405,2763
37033,19192,4566,9627,2649,2848,1497,5108,1732,4694,1649,414,510,202,356,212,369,599,627,1072,799,9565,2592,2030,1191,5633,1928,4966,1786,667,647,374,477,293,457,1136,831,766,667
37035,128811,27116,62494,15733,19256,9959,34547,10229,31847,9678,2700,3091,1549,2271,1151,2061,1883,2409,6808,5459,66317,16076,16140,9405,34565,10214,31857,9717,2708,3209,1690,2534,1018,1945,7133,5129,8479,5687
37037,59391,10547,28161,6510,7000,4095,18232,4346,16891,4068,1341,1469,581,969,760,1019,892,1139,2037,1773,31230,6359,6634,3706,17647,4195,16261,3890,1386,1534,752,1092,634,976,3616,2302,3333,2363
37039,24121,5184,11668,2891,2395,1545,7492,2248,7067,2196,425,527,156,333,269,430,596,692,1185,987,12453,3027,1714,1249,7453,2252,6996,2187,457,555,302,422,155,376,1646,1079,1640,1131
37041,11892,3309,5483,1874,1627,1202,3062,1214,2840,1176,222,342,162,290,60,203,223,359,571,603,6409,1993,1525,1075,3167,1216,2872,1167,295,427,222,370,73,219,1077,785,640,638
37043,9168,2171,4361,1255,766,652,3076,960,2926,935,150,213,72,143,78,165,50,125,469,399,4807,1231,580,486,2898,974,2718,927,180,239,102,161,78,162,681,446,648,446
37045,79761,21477,38024,12289,12808,7575,19504,7217,17506,6461,1998,2585,1198,1940,800,1610,1780,2198,3932,3758,41737,12952,11366,7135,19342,7191,16784,6176,2558,3003,1398,2030,1160,2051,4738,3803,6291,5000
37047,46428,12385,22871,7160,8548,4704,10864,4323,9096,3789,1768,1898,1098,1461,670,1028,952,1190,2507,2158,23557,7497,6765,4379,10792,4300,9503,3902,1289,1572,908,1320,381,842,3428,2508,2572,2216
37049,83612,18169,42234,11160,13028,6837,24087,7276,21874,6846,2213,2413,888,1577,1325,1787,1290,1688,3829,3198,41378,10001,8747,5374,23441,6911,21210,6502,2231,2338,1088,1586,1143,1683,4147,2974,5043,3536
37051,263250,46798,130231,30938,52476,22973,63805,17772,53993,15098,9812,8842,3950,5077,5862,6851,3056,4301,10894,8318,133019,26855,40770,17931,61210,15850,50737,14063,10473,8295,4932,5325,5541,5995,11982,8229,19057,10390
37053,21592,3417,10645,1994,2753,1320,6842,1450,6151,1375,691,686,474,597,217,318,312,371,738,596,10947,1940,2441,1123,6526,1455,6035,1392,491,478,189,316,302,377,895,622,1085,709
37055,30465,6308,14989,3780,4337,2483,8302,2509,7774,2443,528,726,221,543,307,583,444,626,1906,1418,15476,3679,3222,2055,8925,2706,8233,2572,692,895,428,758,264,545,1407,1157,1922,1442
37057,135509,30442,65484,17387,17643,10375,38407,11488,35342,10854,3065,3717,1714,2674,1351,2452,2242,2988,7192,5813,70025,17631,15311,9577,38142,11394,35241,10753,2901,3450,2011,2904,890,1920,7938,5798,8634,6407
37059,35027,7808,16766,4562,4571,2904,10029,2913,9456,2821,573,719,193,426,380,598,551,719,1615,1403,18261,4330,4057,2294,10313,2897,9494,2743,819,925,400,615,419,664,2073,1542,1818,1382
37061,47187,12031,22676,6913,7588,4291,12003,4281,10446,3741,1557,1806,718,1070,839,1252,716,963,2369,1914,24511,6998,6714,3964,11960,4216,10119,3678,1841,1736,1165,1181,676,1025,3258,2264,2579,2086
37063,255928,49254,120495,30892,51936,22551,56402,17481,49619,15344,6783,6969,2606,4059,4177,5371,2308,3696,9849,8209,135433,30502,52579,21521,56976,17425,50232,15508,6744,7287,3920,5518,2824,4421,9150,7516,16728,10806
37065,42735,11676,19297,6661,7529,4648,8900,3559,7870,3230,1030,1349,524,996,506,930,778,1063,2090,1971,23438,7155,8175,4547,9301,3759,8082,3361,1219,1426,807,1167,412,841,3138,2310,2824,2256
37067,303205,63752,141249,38392,52152,27864,72124,21950,66091,20401,6033,7443,2910,5172,3123,5313,3726,5413,13247,10919,161956,38711,53140,26600,73571,21498,66092,19985,7479,8314,4759,6640,2720,4968,14776,11133,20469,13601
37069,54298,10604,26807,6386,8236,4103,15136,4199,13821,3981,1315,1254,839,1012,476,642,602,821,2833,2120,27491,6067,6870,3727,14756,4161,13472,3929,1284,1379,962,1143,322,576,2666,1842,3199,2170
37071,178251,38496,84899,22388,27211,14752,45719,13775,41209,12638,4510,5318,2320,3759,2190,3660,2572,3622,9397,7308,93352,22845,24698,13683,46730,13972,41787,12620,4943,5454,2904,4177,2039,3572,9630,6936,12294,8516
37073,9592,2054,4639,1173,1511,800,2447,794,2374,794,73,154,61,147,12,127,182,217,499,402,4953,1243,1157,671,2642,858,2507,854,135,187,88,159,47,145,490,401,664,500
37075,7077,1607,3411,908,912,581,1972,626,1822,600,150,179,82,159,68,113,112,164,415,370,3666,984,661,504,2025,649,1818,613,207,264,129,219,78,146,523,361,457,374
37077,49361,9587,25051,5923,8974,3942,12577,3492,11110,3108,1467,1335,708,914,759,916,848,1027,2652,1698,24310,5402,6785,3346,11937,3254,10845,3029,1092,1246,592,881,500,800,2441,1724,3147,2008
37079,17485,3228,9752,2125,3999,1579,4350,1303,3226,1010,1124,774,629,531,495,468,329,341,1074,716,7733,1880,2086,1048,3540,1012,2988,904,552,468,318,370,234,287,1019,673,1088,718
37081,430398,83745,200386,51326,76221,37602,99855,28268,90581,25927,9274,10776,4283,7080,4991,7810,5497,7367,18813,15362,230012,52374,82601,37493,99789,27976,88098,25023,11691,11868,6911,8895,4780,7336,19341,13863,28281,18597
37083,42108,11352,19962,6834,7876,4605,9433,4011,8239,3640,1194,1391,618,1079,576,966,851,1184,1802,1620,22146,6481,7600,4359,9067,3802,7895,3481,1172,1404,902,1273,270,723,3112,2255,2367,1971
37085,102734,16885,50394,9986,16223,6568,27904,6274,25352,5766,2552,2323,1134,1352,1418,1827,1205,1362,5062,3418,52340,10198,14624,6296,26753,5936,23727,5362,3026,2532,1685,1843,1341,1596,4826,2909,6137,3408
37087,51999,11453,24762,6749,6139,3916,14491,4523,13457,4252,1034,1427,524,1004,510,1016,1037,1337,3095,2550,27237,6679,5036,3477,14914,4544,13745,4340,1169,1518,722,1237,447,909,3783,2503,3504,2428
37089,96786,19698,46029,11875,12080,7650,27931,7650,26036,7232,1895,2338,956,1697,939,1551,1243,1696,4775,3875,50757,11384,9727,6336,28911,8021,26906,7536,2005,2306,968,1575,1037,1647,5546,3627,6573,4220
37091,20314,4239,10078,2567,4623,1972,4099,1371,3483,1276,616,459,292,332,324,304,481,474,875,621,10236,2682,3466,1611,4053,1358,3241,1122,812,735,468,474,344,408,1577,943,1140,791
37093,41195,6907,20200,4274,7072,3267,10684,2769,9167,2455,1517,1213,834,839,683,795,588,742,1856,1294,20995,4204,6447,2872,10313,2557,8809,2334,1504,1157,556,692,948,905,1808,1484,2427,1592
37095,4370,1207,2318,688,974,400,1075,491,921,480,154,158,88,151,66,103,37,89,232,229,2052,682,491,370,1102,510,983,497,119,169,94,153,25,87,336,273,123,152
37097,142601,27334,69591,16010,20952,10767,40564,10238,37552,9511,3012,3458,1247,2219,1765,2666,1656,2385,6419,4928,73010,16459,18962,10378,39495,9822,36776,9179,2719,3289,1678,2566,1041,2118,6208,4465,8345,5644
37099,37046,8525,17866,5198,7175,3489,8298,2879,7711,2784,587,798,237,498,350,635,761,863,1632,1422,19180,5022,6860,3052,8082,2770,7430,2648,652,833,396,650,256,531,1948,1440,2290,1630
37101,155182,34580,75375,20379,23088,12605,42894,12575,38885,11337,4009,4520,2027,3021,1982,2959,1913,2627,7480,6053,79807,19708,19681,11118,42992,12269,38593,11193,4399,4647,2376,3191,2023,3085,6625,5392,10509,7051
37103,8130,1351,3830,835,1199,528,2180,573,1897,544,283,280,114,175,169,214,109,116,342,250,4300,834,1045,505,2090,549,1855,542,235,218,153,162,82,130,750,435,415,249
37105,48239,10317,23048,6140,7817,4118,11828,3671,10728,3342,1100,1353,519,895,581,911,896,1074,2507,1854,25191,6163,7206,3821,12193,3653,10813,3339,1380,1390,576,800,804,1085,2622,1825,3170,2084
37107,46170,11769,21847,7080,7557,4641,11215,4327,10127,4026,1088,1442,492,976,596,1079,904,1200,2171,2098,24323,6870,6788,3977,11219,4046,9745,3754,1474,1663,1006,1322,468,899,3183,2414,3133,2370
37109,68432,13925,33610,8208,8921,4871,20394,5657,18873,5257,1521,1827,958,1455,563,1036,1018,1353,3277,2603,34822,7860,7145,4316,20252,5408,18589,5124,1663,1949,850,1312,813,1289,2977,2353,4448,3109
37111,37489,8722,18398,5091,5053,2935,10497,3408,9611,3148,886,1136,552,848,334,667,752,928,2096,1654,19091,4850,4032,2671,10822,3448,9988,3301,834,1007,472,727,362,708,1896,1508,2341,1833
37113,29599,6620,14104,3852,3145,2145,8903,2734,8285,2637,618,733,192,462,426,599,601,694,1455,1255,15495,3834,2712,1879,8843,2719,8401,2667,442,667,256,545,186,470,1941,1322,1999,1458
37115,18417,4174,8930,2374,2651,1352,5006,1523,4645,1470,361,413,140,267,221,313,254,315,1019,860,9487,2451,2076,1275,4827,1442,4472,1422,355,419,196,313,159,283,1122,787,1462,954
37117,18974,4783,8740,2819,2838,1778,4513,1635,3963,1527,550,658,427,553,123,361,434,537,955,896,10234,2888,2929,1737,4541,1703,3795,1463,746,858,577,752,169,369,1324,996,1440,1011
37119,859866,161177,407518,98479,164491,74470,203533,57361,182641,52117,20892,22108,8495,13587,12397,16874,6818,11348,32676,27294,452348,101500,163070,72335,205986,57765,183797,52386,22189,23051,12291,16496,9898,15080,29156,24215,54136,35353
37121,12746,2698,6277,1684,1717,1011,3748,1223,3519,1167,229,340,156,298,73,190,191,287,621,500,6469,1479,1203,730,3592,1080,3189,1040,403,381,263,313,140,251,993,639,681,531
37123,22315,6333,10988,3852,3758,2218,5934,2353,5317,2118,617,794,243,469,374,627,467,586,829,796,11327,3544,2686,1821,5981,2336,5320,2110,661,752,325,491,336,545,1354,996,1306,966
37125,80022,17448,38046,10132,9737,5957,22620,6605,20575,6118,2045,2381,984,1534,1061,1639,1354,1671,4335,3623,41976,10548,8597,5666,22251,6498,20624,6139,1627,1944,843,1404,784,1327,5444,3442,5684,3999
37127,77038,19757,36404,11335,12259,7358,19293,6874,17449,6409,1844,2248,1225,1897,619,1240,1231,1736,3621,3217,40634,11777,11864,7259,19209,6932,16970,6319,2239,2484,1385,1809,854,1522,4661,3439,4900,3880
37129,192552,37726,90716,23786,34494,17568,45509,13116,41286,12120,4223,4774,1877,3065,2346,3561,2140,3134,8573,7062,101836,22863,32606,15768,46386,13286,41557,12242,4829,5341,2405,3788,2424,3396,9066,6394,13778,8779
37131,17027,4591,8149,2711,2882,1637,4048,1717,3563,1592,485,534,253,404,232,423,382,523,837,744,8878,2717,2524,1521,4187,1735,3666,1627,521,594,360,503,161,350,1432,1011,735,675
37133,153391,37394,86743,25180,36200,15977,42930,15240,36757,12440,6173,6805,2835,4208,3338,4400,1417,2385,6196,5813,66648,18286,15661,10087,38432,12219,33252,11098,5180,4962,2272,3166,2908,3429,4609,4454,7946,5974
37135,121563,22016,57149,14224,23132,10690,28642,7326,26369,6800,2273,2644,949,1678,1324,2026,937,1530,4438,3896,64414,13920,25552,10012,28472,7289,26060,6667,2412,2785,1046,1759,1366,2025,3616,3256,6774,4498
37137,11195,2171,5644,1337,1489,722,3322,889,3044,852,278,270,146,229,132,199,236,247,597,366,5551,1153,897,507,3330,842,3112,819,218,219,141,168,77,170,716,389,608,380
37139,32037,6025,15429,3627,5337,2525,8206,2271,7599,2150,607,714,254,467,353,581,593,715,1293,1120,16608,3658,4417,2321,8195,2290,7254,2049,941,896,630,707,311,567,1754,1192,2242,1552
37141,49332,9107,24375,5492,7539,3487,13218,3317,11827,2976,1391,1318,727,959,664,845,918,1093,2700,1906,24957,5320,5994,3162,13472,3393,11948,3015,1524,1574,694,1056,830,1052,2628,1712,2863,1835
37143,11310,2428,5479,1400,1300,852,3522,1021,3242,985,280,341,164,276,116,226,193,236,464,430,5831,1430,984,687,3588,1081,3284,1009,304,389,211,308,93,223,707,490,552,460
37145,32538,7916,15652,4599,5106,2935,8480,2811,7715,2633,765,970,506,748,259,503,483,700,1583,1256,16886,4669,3990,2570,8166,2776,7417,2609,749,919,466,712,283,520,2103,1493,2627,1803
37147,146413,33193,67468,20957,29572,15946,31023,10088,28555,9469,2468,3283,1288,2347,1180,2231,1296,2186,5577,5154,78945,20798,33222,15548,31516,10238,27305,9098,4211,4391,2559,3332,1652,2545,5870,4952,8337,6374
37149,17882,2950,8428,1705,1935,912,5215,1230,4846,1161,369,404,117,209,252,342,454,409,824,550,9454,1717,1723,925,5189,1216,4816,1172,373,363,175,240,198,269,1280,611,1262,725
37151,116648,24201,56984,14314,16234,8790,33197,9674,30252,9067,2945,3178,1696,2368,1249,1985,1584,2116,5969,4561,59664,13893,14057,7982,31481,9121,28767,8622,2714,2980,1838,2377,876,1730,6439,4437,7687,5278
37153,36557,10385,17725,5974,6804,4035,8170,3485,7156,3251,1014,1159,530,844,484,803,671,996,2080,1933,18832,6142,5834,3969,8350,3635,7173,3244,1177,1497,870,1272,307,732,2408,1826,2240,2024
37155,104838,18253,49838,10864,21253,8086,22166,6060,18988,5366,3178,2816,1799,2045,1379,1900,1671,1891,4748,3246,55000,11287,19948,7920,22651,6040,19192,5418,3459,2909,2052,2157,1407,1854,6144,3511,6257,3820
37157,75850,17820,36113,10246,10656,6167,19683,6584,17950,6187,1733,2143,1037,1676,696,1290,1314,1757,4460,3576,39737,10681,9576,5980,19989,6601,17834,6061,2155,2473,1321,1882,834,1473,4854,3498,5318,4031
37159,114530,25672,56216,15667,18573,10179,29406,9584,25894,8532,3512,3791,1443,2426,2069,2640,2004,2443,6233,5073,58314,14989,15159,9151,29745,9558,25860,8538,3885,4032,2268,2910,1617,2413,6214,4636,7196,5170
37161,55599,15655,26580,8959,7966,5403,14232,5518,12236,4812,1996,2404,1161,1822,835,1321,1346,1590,3036,2808,29019,9203,6585,4722,14269,5445,12710,4999,1559,1914,1014,1515,545,1072,3638,2820,4527,3541
37163,50573,12979,24607,7633,8626,5014,12432,4478,11074,4136,1358,1554,649,1053,709,1108,1206,1498,2343,2251,25966,7533,7339,4560,12029,4195,10470,3913,1559,1606,943,1165,616,965,3553,2472,3045,2343
37165,28225,4796,13796,2989,5750,2177,6040,1790,5168,1605,872,738,538,582,334,474,584,630,1422,995,14429,2886,5056,2015,6017,1712,5109,1542,908,767,648,635,260,441,1774,1063,1582,1029
37167,50592,10700,24962,6236,7715,4177,13729,3899,12845,3739,884,1096,374,771,510,851,750,1000,2768,2148,25630,6183,6281,3595,13951,3934,12836,3720,1115,1306,579,936,536,902,2903,2026,2495,1973
37169,38747,8987,18815,5356,4710,2993,11129,3740,10426,3568,703,887,387,710,316,601,548,758,2428,2057,19932,5080,3783,2649,11233,3681,10264,3551,969,1072,637,916,332,592,2473,1801,2443,2031
37171,59583,12786,28791,7384,7835,4340,17198,4969,15769,4699,1429,1647,785,1231,644,1096,889,1218,2869,2282,30792,7493,6189,4117,17370,5030,15802,4700,1568,1802,975,1427,593,1103,3764,2508,3469,2495
37173,11485,2421,5516,1396,1698,918,2892,960,2710,938,182,262,70,189,112,222,246,278,680,504,5969,1442,1366,713,2960,966,2622,920,338,350,274,324,64,173,718,516,925,643
37175,29330,6872,13978,3873,3321,1997,8911,2869,8192,2706,719,903,488,760,231,479,526,652,1220,1224,15352,4025,2942,1885,8546,2792,8085,2715,461,656,285,535,176,426,1984,1439,1880,1512
37177,3579,764,2098,502,819,328,910,364,753,341,157,139,85,104,72,99,73,101,296,178,1481,440,239,200,926,351,777,307,149,167,33,80,116,152,223,170,93,106
37179,180541,30268,88051,18085,25488,12071,54826,11212,51831,10563,2995,3360,1406,2299,1589,2467,1497,2216,6240,4989,92490,17323,22744,10599,54995,11012,51238,10375,3757,3915,2289,2954,1468,2400,6381,4608,8370,5656
37181,35755,9595,16310,5590,6509,4143,7823,3138,6678,2757,1145,1322,599,868,546,849,318,561,1660,1468,19445,5757,7056,3938,7688,3039,6750,2787,938,1113,561,865,377,709,2239,1833,2462,1963
37183,854839,142199,410975,88178,144360,64884,229729,51838,213447,48055,16282,18719,8000,12619,8282,13009,6984,11090,29902,25164,443864,87025,138025,60196,228968,50853,210090,46960,18878,19748,10403,14409,8475,12684,25859,20696,51012,31593
37185,16940,3676,8373,2254,3192,1548,3690,1202,3208,1113,482,447,273,349,209,266,495,502,996,691,8567,2248,2741,1451,3378,1100,3017,1038,361,343,226,287,135,246,1283,863,1165,744
37187,9908,3333,4454,1984,1676,1346,2076,1185,1706,1047,370,471,300,424,70,231,170,359,532,624,5454,2105,1730,1279,1822,1066,1487,915,335,502,104,265,231,407,1029,752,873,797
37189,49072,9028,24329,5976,11717,4631,10226,2785,9553,2729,673,799,379,659,294,540,358,637,2028,1624,24743,5629,10556,4094,10394,2955,9719,2775,675,870,404,705,271,539,1609,1320,2184,1537
37191,99079,22638,47846,13627,17828,9572,24194,8055,22026,7504,2168,2615,1309,1996,859,1572,1664,2265,4160,3532,51233,13341,14874,8427,23977,7843,20828,7004,3149,3247,2120,2562,1029,1703,5885,4238,6497,4799
37193,57012,14843,28016,8456,7617,4749,16120,5827,14869,5540,1251,1638,544,1103,707,1236,1274,1569,3005,2766,28996,8473,5154,3871,16775,5887,15167,5551,1608,1768,1120,1505,488,980,3561,2885,3506,2892
37195,65921,15130,30592,8937,11096,6387,15390,5170,13545,4579,1845,2118,1210,1685,635,1126,959,1320,3147,2698,35329,9190,11126,5709,15472,5150,13482,4504,1990,2121,1226,1612,764,1356,4113,2939,4618,3187
37197,31150,6926,15214,4123,3927,2443,9360,2846,8661,2691,699,839,310,574,389,597,318,490,1609,1390,15936,3815,2898,1957,9220,2744,8564,2618,656,801,349,567,307,574,2097,1371,1721,1255
37199,15091,3118,7302,1808,1735,973,4586,1144,4216,1094,370,373,250,303,120,229,334,364,647,580,7789,1711,1397,870,4682,1178,4332,1135,350,372,125,209,225,307,891,572,819,554
38001,1893,324,916,187,227,103,580,143,568,142,12,32,0,27,12,32,38,33,71,55,977,189,140,85,608,150,557,139,51,50,0,27,51,50,148,81,81,49
38003,9037,1684,4485,1033,1376,707,2572,711,2444,694,128,156,11,107,117,159,134,185,403,328,4552,1002,1142,591,2557,740,2458,709,99,170,17,112,82,167,471,321,382,318
38005,4820,604,2460,363,1147,266,1005,227,960,225,45,60,15,55,30,59,80,66,228,121,2360,354,921,247,1041,238,944,222,97,81,48,62,49,80,186,105,212,119
38007,746,67,408,45,91,34,266,37,253,34,13,12,0,9,13,12,14,12,37,20,338,39,27,17,240,29,240,29,0,9,0,9,0,9,50,24,21,12
38009,5336,853,2770,531,746,334,1646,412,1542,374,104,126,16,60,88,124,55,57,323,186,2566,463,411,231,1615,364,1539,356,76,96,19,66,57,93,312,164,228,163
38011,2499,407,1241,239,293,132,815,188,782,185,33,47,12,37,21,41,53,45,80,75,1258,222,240,99,790,179,757,182,33,41,19,39,14,38,149,97,79,64
38013,1640,161,880,98,246,68,510,82,497,82,13,13,0,18,13,13,23,17,101,48,760,99,93,53,531,94,501,89,30,28,0,18,30,28,86,32,50,24
38015,76084,12477,37906,7845,12815,5623,20738,4916,19966,4795,772,1046,183,637,589,913,806,1063,3547,2825,38178,7375,10319,4987,19936,4645,19299,4559,637,951,207,651,430,787,3321,2169,4602,3208
38017,143026,21094,72288,13894,29991,10870,35320,8094,33523,7781,1797,2258,618,1402,1179,1831,1483,1975,5494,4113,70738,12465,23207,8675,36133,8196,34196,7898,1937,2303,660,1476,1277,1827,4648,3382,6750,4519
38019,3115,435,1577,258,371,182,1066,233,1009,230,57,75,15,48,42,69,28,43,112,90,1538,260,186,129,992,205,970,209,22,34,4,43,18,36,237,116,123,90
38021,3995,713,1980,368,567,255,1133,279,1107,280,26,60,4,52,22,57,55,60,225,158,2015,459,398,261,1187,301,1174,297,13,61,2,59,11,65,290,188,140,106
38023,2024,280,978,141,232,88,596,126,556,127,40,38,30,32,10,20,31,27,119,61,1046,175,250,100,565,127,547,128,18,21,0,18,18,21,112,62,119,68
38025,3519,388,1863,246,533,139,1107,192,975,158,132,115,41,92,91,67,45,56,178,106,1656,215,361,116,998,168,964,169,34,34,7,28,27,33,156,76,141,68
38027,1930,260,926,161,261,117,556,113,540,112,16,29,5,26,11,26,33,35,76,47,1004,166,218,113,577,120,563,122,14,25,8,28,6,20,140,66,69,41
38029,2760,395,1422,206,312,117,894,170,866,168,28,34,8,21,20,32,53,35,163,85,1338,234,130,81,891,171,879,171,12,29,0,36,12,29,207,94,110,78
38031,2673,325,1330,175,348,131,817,143,780,143,37,32,5,26,32,30,77,65,88,60,1343,196,231,102,807,153,759,145,48,43,15,21,33,36,202,87,103,64
38033,1524,177,770,112,203,94,392,82,384,83,8,12,3,13,5,17,41,29,134,74,754,126,199,91,406,84,395,83,11,16,0,18,11,16,61,33,88,49
38035,57611,10093,29858,6984,13317,5427,13663,3880,12677,3665,986,1187,218,687,768,996,428,696,2450,1971,27753,5842,9614,4084,13410,3713,12540,3547,870,1074,276,719,594,906,1893,1435,2836,2098
38037,1956,162,1017,96,308,74,601,77,566,79,35,24,7,14,28,23,42,24,66,36,939,93,122,40,595,77,576,74,19,21,1,12,18,20,120,42,102,32
38039,1996,239,989,138,266,81,582,103,532,101,50,45,5,9,45,44,40,27,101,42,1007,127,148,63,599,106,581,101,18,18,7,10,11,15,195,67,65,38
38041,2087,253,974,130,179,70,642,112,594,104,48,29,15,28,33,23,48,44,105,59,1113,173,225,93,640,125,585,113,55,55,31,36,24,38,151,79,97,58
38043,2049,346,1092,197,303,114,695,154,671,152,24,32,4,18,20,26,9,15,85,45,957,179,132,73,651,153,645,154,6,19,4,24,2,22,98,44,76,50
38045,3389,372,1725,201,421,129,1124,162,1092,160,32,38,0,36,32,38,51,42,129,69,1664,217,263,126,1113,164,1091,167,22,30,7,29,15,26,198,72,90,58
38047,1569,170,805,94,211,67,491,73,462,72,29,27,3,13,26,25,35,28,68,33,764,112,121,56,478,76,462,79,16,14,0,18,16,14,122,49,43,27
38049,4729,433,2421,266,702,193,1454,210,1427,213,27,27,0,36,27,27,60,48,205,108,2308,254,471,143,1401,200,1377,198,24,39,2,22,22,38,276,99,160,81
38051,2213,245,1101,144,236,83,710,118,689,119,21,25,0,27,21,25,45,39,110,62,1112,150,144,62,634,116,600,116,34,33,0,27,34,33,262,93,72,46
38053,9702,1663,5356,1161,2401,835,2253,583,1821,535,432,347,81,110,351,301,160,138,542,328,4346,877,1199,524,2301,557,2208,551,93,95,40,80,53,70,332,192,514,316
38055,7844,1065,4047,644,936,392,2634,504,2499,474,135,138,34,79,101,121,119,97,358,208,3797,575,625,284,2440,437,2376,429,64,82,22,68,42,70,431,211,301,173
38057,6872,1025,3542,574,793,375,2234,490,2148,491,86,102,17,57,69,95,149,140,366,228,3330,629,386,249,2360,500,2294,503,66,75,22,66,44,69,336,239,248,192
38059,25121,4930,12626,3043,3423,1816,8011,2258,7419,2080,592,761,191,312,401,629,326,439,866,774,12495,2652,2375,1391,7426,2157,7219,2110,207,351,60,218,147,307,1300,907,1394,1036
38061,7950,1154,4321,745,1775,535,1920,420,1706,386,214,177,8,34,206,174,61,78,565,318,3629,586,1118,390,1971,402,1778,367,193,157,56,65,137,128,301,183,239,148
38063,2454,315,1245,185,314,142,761,138,735,132,26,39,3,16,23,36,37,29,133,62,1209,190,184,104,723,145,691,139,32,32,12,25,20,29,185,72,117,62
38065,1451,183,734,101,133,57,560,84,543,85,17,17,6,8,11,21,16,20,25,21,717,100,92,37,554,89,527,91,27,33,27,33,0,18,37,26,34,33
38067,5753,802,3009,502,883,331,1778,391,1687,378,91,120,31,107,60,96,111,111,237,164,2744,464,429,240,1763,370,1704,366,59,107,25,99,34,91,351,209,201,127
38069,3371,655,1645,370,354,218,998,317,949,309,49,77,4,44,45,75,36,56,257,174,1726,392,265,172,920,285,869,270,51,80,15,59,36,68,225,139,316,184
38071,9366,2152,4742,1273,1567,910,2442,842,2343,812,99,164,35,121,64,144,147,184,586,482,4624,1351,1155,809,2456,850,2319,798,137,225,0,108,137,225,554,392,459,428
38073,4420,662,2158,386,616,247,1227,269,1177,255,50,62,2,49,48,61,91,76,224,143,2262,412,403,204,1347,319,1307,320,40,51,10,42,30,52,280,134,232,154
38075,1888,288,981,181,288,115,570,112,536,108,34,38,6,27,28,32,17,21,106,69,907,160,136,67,562,124,554,126,8,22,4,23,4,26,94,54,115,77
38077,13325,1795,6942,1130,2643,823,3645,746,3550,737,95,145,16,113,79,141,133,172,521,370,6383,1085,1642,714,3428,685,3292,682,136,176,69,159,67,119,741,410,572,398
38079,10295,1926,5054,1171,2302,889,2050,660,1817,607,233,244,103,179,130,175,155,177,547,377,5241,1152,2162,758,2053,660,1881,632,172,198,90,165,82,149,462,336,564,364
38081,3234,386,1735,246,461,172,1072,193,988,178,84,81,9,46,75,80,56,49,146,88,1499,220,184,99,1036,187,1021,186,15,32,1,47,14,31,158,71,121,64
38083,1215,79,631,46,193,44,374,43,358,42,16,10,4,5,12,9,22,12,42,14,584,43,43,17,355,37,338,39,17,14,8,11,9,7,108,33,78,27
38085,3064,306,1540,187,885,157,404,101,358,92,46,40,13,31,33,46,29,26,222,79,1524,192,766,166,433,104,372,93,61,47,22,40,39,41,148,59,177,72
38087,612,71,313,44,80,26,208,31,199,31,9,7,0,9,9,7,8,6,17,13,299,40,29,17,211,29,204,30,7,7,0,9,7,7,51,21,8,6
38089,24192,4728,12475,2990,4000,1953,7048,1979,6162,1789,886,796,216,443,670,655,200,332,1227,948,11717,2710,2921,1693,6450,1844,6142,1769,308,488,93,298,215,404,1173,723,1173,875
38091,1435,187,781,100,162,71,467,82,464,82,3,13,3,13,0,18,35,25,117,54,654,114,96,53,467,88,467,88,0,18,0,18,0,18,55,32,36,23
38093,17455,3675,8967,2340,3282,1605,4344,1454,4084,1368,260,306,70,208,190,273,332,443,1009,797,8488,2139,2085,1289,4406,1506,4126,1383,280,421,54,229,226,373,902,827,1095,863
38095,1825,354,1000,229,334,160,555,140,545,140,10,24,4,26,6,25,36,37,75,61,825,180,119,76,505,127,494,127,11,18,6,15,5,17,145,83,56,43
38097,6557,1036,3338,621,1060,404,1848,404,1749,382,99,122,14,83,85,115,92,108,338,202,3219,586,698,350,1904,389,1789,376,115,150,7,74,108,149,370,190,247,154
38099,8705,1262,4415,786,1358,566,2537,551,2472,540,65,137,23,125,42,126,151,136,369,233,4290,752,898,413,2493,536,2420,524,73,131,24,116,49,112,582,315,317,218
38101,54578,10877,28646,6791,10847,4991,14599,4161,13697,4017,902,1168,200,633,702,1009,649,956,2551,2069,25932,6097,6575,3561,14279,4024,13498,3892,781,1130,314,776,467,803,2166,1716,2912,2178
38103,3218,489,1589,291,366,229,982,233,962,233,20,42,0,45,20,42,101,87,140,96,1629,311,227,145,1016,260,990,256,26,45,7,46,19,40,258,116,128,96
38105,26687,5714,14630,3475,5312,2441,7134,2190,6707,2176,427,479,109,286,318,391,326,421,1858,1357,12057,3107,3211,1836,6733,2129,6538,2114,195,301,119,268,76,212,906,636,1207,1044
39001,22316,5641,10968,3300,3300,2023,5653,1918,5227,1834,426,524,180,383,246,430,603,644,1412,1073,11348,3077,2380,1493,5738,1905,5210,1787,528,648,363,513,165,341,1224,941,2006,1394
39003,83498,16866,41841,10346,14861,7432,20469,5987,19164,5679,1305,1811,481,1290,824,1556,1262,1644,5249,3842,41657,10014,11329,6348,19947,5824,18586,5512,1361,1946,793,1541,568,1388,4536,3300,5845,4101
39005,43669,8849,21129,5123,6743,3509,11588,3288,10700,3093,888,1159,394,814,494,846,398,686,2400,1788,22540,5318,5782,3225,11765,3385,11017,3226,748,1041,322,688,426,825,2439,1717,2554,1847
39007,80078,19213,40050,11258,13793,7467,19048,6607,17689,6294,1359,1817,590,1441,769,1404,1450,2022,5759,4248,40028,11186,10056,6520,19423,6777,17916,6436,1507,2099,943,1706,564,1449,4399,3302,6150,4501
39009,58104,11421,28744,7557,15323,5908,10464,3511,9346,3194,1118,1453,472,952,646,1083,856,1134,2101,1733,29360,7003,14390,5257,10128,3338,9432,3201,696,986,256,674,440,865,2136,1647,2706,1946
39011,36639,6635,18083,3968,4947,2520,10848,2609,10374,2502,474,712,125,505,349,635,650,764,1638,1420,18556,3791,3782,2147,10950,2669,10635,2599,315,608,143,514,172,518,2043,1380,1781,1321
39013,57480,12552,29447,7612,10803,5457,13802,4418,12353,4112,1449,1564,515,1056,934,1288,915,1245,3927,2810,28033,7351,6640,4290,14284,4637,13187,4327,1097,1559,355,957,742,1375,3581,2421,3528,2749
39015,35406,7164,17563,4391,4610,2693,10198,2883,9423,2728,775,923,352,609,423,661,698,820,2057,1509,17843,4014,3598,2176,9844,2804,9357,2735,487,640,273,499,214,470,1850,1345,2551,1770
39017,306052,66992,148433,39726,52282,27684,77766,22767,72535,21346,5231,7211,2366,4912,2865,5358,3944,5774,14441,12131,157619,40083,46580,25859,78885,23079,73044,21554,5841,7482,3050,5430,2791,5271,13118,10550,19036,13757
39019,22725,4880,11333,2802,2872,1608,6537,1974,6259,1964,278,480,147,389,131,358,364,485,1560,1037,11392,2834,2263,1468,6691,1998,6379,1955,312,491,162,390,150,371,1042,842,1396,1050
39021,31780,6307,15732,3786,4581,2389,8510,2421,8113,2344,397,613,201,494,196,484,493,697,2148,1467,16048,3684,3400,2079,8993,2542,8598,2472,395,653,246,560,149,463,1580,1120,2075,1382
39023,109730,24200,52368,14309,16764,9338,26864,8659,24999,8121,1865,2747,826,1987,1039,2208,2323,2832,6417,5116,57362,14196,15348,8797,26939,8711,24761,8074,2178,2845,1321,2359,857,1992,6509,4577,8566,5719
39025,165043,28559,80598,17392,23562,11945,46642,11134,44203,10619,2439,3280,1094,2208,1345,2456,2265,2898,8129,6083,84445,16801,19278,10510,46804,11011,43789,10506,3015,3496,1756,2667,1259,2264,7586,5352,10777,6826
39027,33886,6455,16575,3755,5056,2391,8772,2383,8246,2268,526,701,236,504,290,524,807,857,1940,1397,17311,3825,4523,2360,8859,2322,8268,2254,591,678,321,542,270,519,1683,1113,2246,1515
39029,85853,18288,43209,11295,13276,7266,22917,7189,21249,6847,1668,1961,667,1454,1001,1537,1434,2022,5582,4222,42644,10646,9536,6128,22080,6960,20626,6649,1454,2167,808,1610,646,1565,5148,3779,5880,4446
39031,29506,6052,14400,3514,4055,2184,8046,2329,7645,2260,401,588,232,493,169,454,529,645,1770,1320,15106,3536,3256,1907,8265,2371,7962,2334,303,552,117,430,186,463,1820,1258,1765,1284
39033,34303,7802,16608,4461,4831,2793,9198,3022,8468,2856,730,998,357,754,373,789,564,891,2015,1618,17695,4570,3873,2636,9142,2966,8369,2818,773,993,349,705,424,808,2222,1610,2458,1823
39035,1032450,217534,485008,131392,202584,97883,214807,72273,196703,66920,18104,25598,8191,18664,9913,19738,14918,21464,52699,42765,547442,136418,200388,96519,219200,73332,198029,66999,21171,27723,11634,21333,9537,19599,54412,39723,73442,49301
39037,41491,8696,20352,5045,5412,3053,12068,3358,11630,3272,438,798,263,686,175,665,890,1041,1982,1603,21139,4932,4133,2588,12241,3384,11807,3287,434,792,160,616,274,694,2330,1733,2435,1807
39039,31030,6682,15308,3851,4642,2533,8718,2550,8244,2486,474,731,291,612,183,495,398,606,1550,1251,15722,3938,3757,2317,8721,2652,8198,2523,523,793,224,557,299,612,1632,1242,1612,1281
39041,157077,23368,77157,13837,20618,9421,48966,9124,47638,8939,1328,2078,261,1152,1067,1874,1752,2379,5821,4431,79920,14236,18161,8960,48004,9073,46031,8691,1973,2633,816,1655,1157,2054,5491,4100,8264,5285
39043,62275,14693,30288,8782,9086,5673,16167,5460,14893,5044,1274,1777,579,1282,695,1297,1058,1488,3977,3176,31987,8591,8003,5209,15971,5233,14786,4880,1185,1648,592,1252,593,1226,3442,2733,4571,3427
39045,124181,22341,61367,13680,19088,9336,34276,8372,32287,7875,1989,2481,901,1767,1088,1730,1601,2068,6402,4713,62814,12857,15090,8077,34464,8283,32259,7838,2205,2805,1165,1961,1040,1937,5463,3903,7797,4941
39047,22989,4302,11096,2607,3057,1598,6075,1852,5582,1752,493,586,330,507,163,335,421,482,1543,1089,11893,2514,2528,1388,5996,1818,5501,1734,495,571,292,464,203,405,1273,856,2096,1351
39049,1034567,224731,499617,139750,211023,104061,228282,75210,207060,68563,21222,27121,7954,16884,13268,21247,10400,17331,49912,41398,534950,135585,196451,95063,229692,74446,206496,67846,23196,28141,11505,19445,11691,19878,36837,32552,71970,49357
39051,34046,5974,16574,3409,4510,2095,9819,2377,9483,2311,336,548,145,443,191,431,550,604,1695,1248,17472,3474,4038,2098,9898,2371,9425,2282,473,654,259,529,214,442,1649,1211,1887,1235
39053,24322,5566,11868,3211,3209,1816,6563,2151,6148,2090,415,613,230,479,185,387,407,551,1689,1353,12454,3226,2635,1673,6500,2098,6193,2063,307,473,188,411,119,336,1595,1069,1724,1368
39055,76526,14209,37705,8352,10260,5335,23530,5383,22784,5290,746,1143,210,843,536,1005,1007,1382,2908,2493,38821,7914,8541,4779,23694,5414,23015,5307,679,1122,258,892,421,934,3512,2715,3074,2465
39057,138153,24916,67358,15032,23384,10463,35533,9360,33518,8917,2015,2672,693,1690,1322,2227,2140,2801,6301,4945,70795,15239,20113,9645,36156,9545,33651,8916,2505,3102,1197,2230,1308,2272,6174,4649,8352,5654
39059,32009,6844,15792,4095,4800,2681,8255,2522,7826,2440,429,584,207,452,222,473,608,809,2129,1501,16217,3978,3546,2259,7895,2447,7346,2310,549,777,364,667,185,477,2059,1354,2717,1689
39061,656270,148702,312885,91397,128380,67440,145603,50305,133666,46650,11937,17197,5439,12188,6498,12976,8684,13486,30218,27488,343385,90977,122838,63594,146938,50369,134334,46552,12604,17775,6652,13170,5952,12510,29956,25114,43653,32644
39063,61822,12825,30467,7863,9323,5249,16836,5042,15954,4903,882,1330,485,1073,397,954,1060,1372,3248,2576,31355,7409,7588,4362,16465,4956,15557,4801,908,1355,348,943,560,1078,3192,2453,4110,3004
39065,25454,5310,12439,3151,4164,2043,6496,1929,6266,1902,230,405,125,375,105,330,368,481,1411,1028,13015,3013,3565,1780,6888,2033,6423,1961,465,604,311,509,154,401,1312,899,1250,927
39067,12638,2719,6219,1518,1515,815,3638,1104,3343,1028,295,384,112,229,183,315,209,250,857,533,6419,1578,1210,794,3808,1111,3682,1108,126,241,60,197,66,209,719,509,682,493
39069,21978,4302,10776,2506,3167,1643,6127,1615,5876,1553,251,416,109,324,142,359,445,510,1037,822,11202,2503,2493,1391,6096,1625,5787,1547,309,446,161,357,148,357,1223,839,1390,953
39071,34619,7926,16723,4486,4707,2923,8866,2796,8330,2670,536,808,237,574,299,628,692,853,2458,1838,17896,4588,4254,2632,9115,2890,8338,2683,777,1023,386,666,391,745,2117,1613,2410,1716
39073,23315,4738,11445,2744,3077,1707,6328,1786,6064,1734,264,440,107,335,157,365,547,581,1493,1014,11870,2728,2592,1559,6578,1813,6219,1747,359,451,177,356,182,342,1080,832,1620,1087
39075,32446,5964,16047,3483,5395,2354,9455,2030,8868,1895,587,632,75,282,512,606,449,547,748,733,16399,3370,4723,2137,9242,1992,8880,1936,362,469,130,310,232,401,1256,985,1178,969
39077,46643,9371,22897,5531,7011,3782,12457,3440,11560,3303,897,1046,410,749,487,800,587,867,2842,2064,23746,5453,5462,3182,12962,3625,11754,3373,1208,1333,645,973,563,863,2466,1798,2856,1964
39079,25942,7111,12533,4028,3546,2305,7325,2763,6754,2628,571,858,478,818,93,380,304,528,1358,1329,13409,4101,2714,2000,7481,2768,6749,2611,732,963,542,835,190,469,1607,1287,1607,1361
39081,55860,11929,26828,7054,8832,4625,13586,4276,12754,4081,832,1161,419,886,413,914,886,1180,3524,2574,29032,6905,8003,4240,13636,4282,12883,4090,753,1126,419,966,334,826,3267,2261,4126,2773
39083,49969,10665,24055,6375,7496,4210,13570,4108,12932,3955,638,961,428,822,210,615,716,986,2273,1899,25914,6122,6877,3560,14094,4180,13360,4036,734,1046,391,761,343,777,2147,1746,2796,1991
39085,192214,32654,93088,20253,30188,14244,49951,12685,47208,12114,2743,3659,1170,2519,1573,2871,2925,3598,10024,7142,99126,19697,25152,12388,50556,12789,47733,12311,2823,3840,1410,2753,1413,2863,9976,6766,13442,8518
39087,49296,13531,23726,8073,7248,5064,12097,4610,11304,4379,793,1273,415,936,378,954,1029,1385,3352,2897,25570,7910,6032,4225,12353,4808,10930,4159,1423,1953,923,1535,500,1108,3250,2781,3935,3066
39089,140462,28153,68047,16808,20932,11285,37670,10225,35727,9806,1943,2726,947,1957,996,2074,1959,2684,7486,5838,72415,16469,18171,10075,38032,10387,35627,9762,2405,3213,1211,2268,1194,2251,6583,4934,9629,6419
39091,36587,7558,17957,4420,4594,2703,10667,2915,10131,2805,536,754,312,594,224,526,472,680,2224,1607,18630,4258,3598,2200,11044,3013,10509,2953,535,759,328,649,207,518,1830,1379,2158,1450
39093,251896,45388,122838,27450,42547,19532,62422,16405,58052,15479,4370,5049,1480,3110,2890,4288,4287,5140,13582,9657,129058,27199,36253,17683,63365,16445,59031,15568,4334,5502,1985,3712,2349,4172,12949,8972,16491,10595
39095,348118,80957,166513,48942,65417,35168,76160,27119,70369,25119,5791,8812,2711,6544,3080,6769,4963,7755,19973,16683,181605,49225,60715,33459,76688,27059,69896,24851,6792,9537,3454,7080,3338,7043,17100,14134,27102,19541
39097,36600,5758,20144,3849,7767,2737,9058,2123,7834,1935,1224,807,598,693,626,459,512,494,2807,1405,16456,3098,3758,1821,8972,2177,8255,2000,717,808,501,646,216,451,1534,971,2192,1263
39099,192153,40333,92859,25027,34103,17654,44370,14341,41240,13471,3130,4559,1418,3412,1712,3537,3498,4485,10888,8642,99294,24152,30267,16233,43702,13675,40392,12773,3310,4582,1710,3396,1600,3547,11950,8433,13375,9427
39101,54070,11334,28957,7011,9900,4321,13463,4495,11864,4189,1599,1364,633,977,966,1002,1027,1251,4567,2741,25113,6475,5790,3732,12698,4122,11524,3873,1174,1508,630,1099,544,1059,3047,2212,3578,2530
39103,145531,24917,71554,15191,20161,10293,42776,9467,41091,9155,1685,2503,684,1711,1001,2010,1856,2455,6761,5178,73977,14397,16427,8857,42150,9251,40142,8889,2008,2777,761,1798,1247,2193,6882,4660,8518,5573
39105,19082,4578,9451,2675,2669,1649,4987,1638,4637,1551,350,485,120,301,230,421,330,428,1465,1011,9631,2514,1995,1232,5013,1635,4703,1573,310,434,118,305,192,368,1308,940,1315,935
39107,32101,6079,16122,3594,4511,2369,9734,2390,9390,2321,344,580,105,432,239,530,394,529,1483,1072,15979,3450,3182,1931,9773,2391,9423,2339,350,551,172,475,178,432,1695,1076,1329,1080
39109,85405,19424,41750,11475,12555,7712,22953,6738,21747,6487,1206,1912,427,1291,779,1597,1551,2029,4691,4031,43655,11496,10290,7113,22888,6867,21886,6511,1002,1851,424,1346,578,1422,4605,3605,5872,4383
39111,11586,2724,5732,1545,1731,981,3134,1005,3023,991,111,210,83,188,28,175,219,278,648,459,5854,1564,1213,758,3089,1000,2951,977,138,251,58,202,80,219,887,585,665,531
39113,433998,88948,205890,53665,76744,37854,98476,31571,90824,29263,7652,10407,3283,7088,4369,8123,6823,8980,23847,18468,228108,54606,71332,35452,100229,31645,91730,29431,8499,10942,4786,8392,3713,7475,22670,17083,33877,21969
39115,12139,2538,6035,1461,1627,802,3417,998,3210,969,207,274,139,237,68,195,195,244,796,543,6104,1419,1268,764,3223,965,3087,942,136,238,75,189,61,180,740,479,873,529
39117,28570,6095,14288,3538,3975,2329,8315,2366,7699,2254,616,764,232,448,384,581,428,586,1570,1224,14282,3443,2974,1786,8333,2508,7572,2251,761,890,232,410,529,761,1269,1101,1706,1173
39119,69926,16146,33518,9439,10888,6071,17469,5769,16457,5471,1012,1450,448,1097,564,1185,1087,1540,4074,3287,36408,9629,9337,5599,17674,5863,16450,5524,1224,1697,661,1304,563,1174,3875,2988,5522,3721
39121,12197,2614,7500,1890,2288,749,3630,1266,3048,1186,582,379,152,220,430,303,258,294,1324,865,4697,1243,740,537,2646,845,2534,828,112,200,30,144,82,169,694,447,617,435
39123,34559,6650,17034,3868,4162,2378,10184,2830,9674,2771,510,713,122,488,388,632,890,967,1798,1324,17525,3953,3560,2369,9854,2756,9316,2641,538,762,239,627,299,617,2118,1438,1993,1456
39125,15111,2586,7544,1449,1949,905,4453,1057,4287,1031,166,228,84,196,82,208,211,250,931,554,7567,1504,1479,837,4442,1045,4293,1030,149,250,113,234,36,187,757,496,889,580
39127,29070,6351,14441,3754,4098,2273,7814,2450,7175,2347,639,829,341,592,298,565,494,652,2035,1476,14629,3590,3371,1991,7806,2378,7013,2253,793,930,420,608,373,636,1199,977,2253,1553
39129,47680,8895,25455,5288,9423,3691,12499,3215,11301,2998,1198,940,490,648,708,758,718,895,2815,1747,22225,5033,5196,3009,11522,2951,10855,2827,667,934,389,681,278,620,1999,1513,3508,2284
39131,22773,5873,11078,3424,3314,2079,5811,2035,5326,1907,485,684,352,607,133,348,564,636,1389,1066,11695,3263,2400,1693,6414,2229,5845,2113,569,683,381,574,188,381,1199,969,1682,1280
39133,137776,26368,67018,16315,25800,12098,32226,8894,30145,8360,2081,2851,865,1879,1216,2155,1776,2425,7216,5658,70758,16084,23575,11275,33041,9011,30616,8480,2425,3187,1220,2299,1205,2117,5724,4351,8418,5765
39135,33581,5746,16509,3374,4252,1987,9936,2389,9409,2297,527,643,261,520,266,454,493,612,1828,1251,17072,3345,3510,1768,9621,2295,9197,2243,424,592,210,426,214,483,1843,1118,2098,1386
39137,26634,4268,13257,2475,3475,1687,8529,1724,8364,1716,165,335,68,319,97,305,262,349,991,745,13377,2533,2696,1451,8431,1722,8107,1659,324,480,134,388,190,399,1153,793,1097,815
39139,99436,19717,50438,11923,17008,7679,25788,7773,23412,7204,2376,2344,960,1658,1416,1827,1687,2170,5955,4153,48998,11381,11277,6472,25231,7648,23434,7201,1797,2304,1066,1840,731,1528,5938,4226,6552,4463
39141,63432,13282,33350,7756,11122,4776,16507,5205,14788,4894,1719,1553,633,1128,1086,1152,1094,1395,4627,3022,30082,7761,6904,4344,15816,5072,14538,4813,1278,1633,491,1016,787,1358,2803,2381,4559,3200
39143,48122,10810,23567,6420,7465,4080,12691,4068,12044,3924,647,1078,315,858,332,843,719,1025,2692,2231,24555,6142,6326,3702,12339,3977,11439,3750,900,1301,407,945,493,955,2497,1828,3393,2395
39145,62433,15318,30475,8845,10028,5492,15346,5499,14038,5165,1308,1803,624,1307,684,1319,1105,1555,3996,3303,31958,9174,8002,5105,15496,5745,13848,5127,1648,2127,835,1435,813,1537,4109,3206,4351,3424
39147,45467,9423,22478,5421,8087,3896,11021,3262,10354,3120,667,1045,366,855,301,813,786,989,2584,1987,22989,5726,6418,3647,11262,3380,10563,3180,699,1096,394,898,305,804,2172,1580,3137,2123
39149,38706,7663,19310,4511,5779,2750,10993,2787,10399,2649,594,828,319,640,275,578,707,889,1831,1490,19396,4388,4737,2580,10879,2830,10212,2660,667,845,294,609,373,688,1834,1345,1946,1411
39151,306644,59799,147252,35773,49407,24875,75716,21692,72046,20776,3670,5769,1770,4347,1900,4420,4881,6397,17248,12507,159392,35320,43536,22775,76958,21876,72779,21033,4179,5933,2162,4523,2017,4528,16436,11663,22462,14401
39153,447725,98727,214941,59241,78248,42138,106618,34064,100775,32232,5843,9732,2816,7472,3027,7344,6480,9644,23595,19806,232784,59812,69131,38275,109462,34846,100615,32266,8847,12037,4293,8446,4554,8910,22412,17658,31779,22535
39155,166776,37108,80510,21857,26615,14579,40643,13637,38041,12918,2602,3941,1472,3326,1130,2793,3132,4316,10120,7862,86266,22548,22257,13914,41623,13780,38915,13138,2708,4063,1541,3255,1167,2881,10229,7423,12157,8862
39157,75034,16379,36643,9552,10445,6058,20914,6161,19876,5947,1038,1539,436,1111,602,1270,1423,1768,3861,3208,38391,9503,8816,5511,20686,6050,19596,5846,1090,1663,559,1267,531,1207,3945,3217,4944,3647
39159,45337,7117,21553,4264,5941,2791,13166,2817,12670,2766,496,655,285,540,211,456,460,613,1986,1377,23784,4125,6183,2630,13055,2810,12232,2681,823,741,404,666,419,428,1640,1253,2906,1521
39161,22837,4089,11202,2413,3038,1490,6490,1594,6284,1593,206,389,54,303,152,375,329,469,1345,925,11635,2378,2350,1264,6656,1644,6175,1572,481,583,214,413,267,473,1242,869,1387,863
39163,10666,2591,5349,1498,1517,877,2684,946,2518,914,166,219,44,136,122,205,266,288,882,647,5317,1467,1090,694,2796,959,2602,919,194,280,152,265,42,147,734,548,697,488
39165,182852,31141,91616,19189,27182,12567,54587,12263,51881,11824,2706,3150,753,1890,1953,2542,2086,2720,7761,6006,91236,17865,19582,10590,54744,12146,52659,11903,2085,2870,974,1994,1111,2144,6920,5414,9990,6843
39167,50715,10140,24897,6089,7679,3964,13252,3957,12501,3800,751,1112,290,730,461,891,1068,1161,2898,2243,25818,5897,6258,3374,13443,4016,12628,3817,815,1112,414,823,401,824,2899,1998,3218,2128
39169,92761,15910,45468,9743,14015,6798,25380,5988,24183,5706,1197,1864,635,1454,562,1282,1323,1660,4750,3425,47293,9613,12357,6258,25284,5920,24179,5740,1105,1633,627,1342,478,1144,4444,3086,5208,3482
39171,29993,6056,14867,3615,4627,2324,7850,2256,7422,2183,428,604,132,424,296,537,658,763,1732,1370,15126,3550,3539,2023,7913,2286,7515,2205,398,640,209,504,189,519,1808,1206,1866,1273
39173,108262,20876,52875,12778,20889,9656,25859,6677,24449,6196,1410,2004,739,1603,671,1459,1122,1593,5005,3724,55387,12860,19298,9282,25652,6473,24672,6267,980,1654,549,1338,431,1282,4420,3256,6017,3992
39175,17845,3342,8717,2008,2500,1330,5139,1413,4843,1358,296,431,134,320,162,342,221,302,857,671,9128,1918,1823,1017,5059,1427,4764,1376,295,412,190,360,105,266,845,636,1401,861
40001,17207,2685,8494,1606,2590,1001,4542,1072,4108,1022,434,349,198,247,236,253,285,261,1077,575,8713,1530,2050,821,4483,1078,3916,986,567,425,277,288,290,290,969,498,1211,597
40003,4901,596,3029,454,844,254,1443,293,1155,221,288,148,100,88,188,104,151,103,591,185,1872,275,278,117,1098,198,1039,194,59,46,25,51,34,38,287,110,209,104
40005,11279,1474,5963,1027,1916,669,2937,610,2584,552,353,189,94,127,259,158,226,183,884,381,5316,744,981,389,2955,564,2746,526,209,189,121,151,88,126,644,294,736,354
40007,4226,697,2125,413,590,239,1260,300,1182,286,78,88,8,67,70,91,67,66,208,135,2101,402,375,187,1274,289,1178,287,96,84,45,81,51,71,234,137,218,142
40009,17554,4976,9762,3050,3229,1788,4546,1889,3934,1711,612,578,194,302,418,524,280,377,1707,1151,7792,2646,1638,1307,4183,1701,3934,1637,249,415,87,265,162,325,836,854,1135,931
40011,7902,1399,4225,858,1208,487,2187,691,1757,611,430,256,109,141,321,235,179,193,651,367,3677,879,488,380,2218,701,2072,655,146,214,71,169,75,175,456,293,515,401
40013,37378,5455,17992,3369,5799,2284,9113,2183,8393,2053,720,772,350,503,370,539,724,688,2356,1336,19386,3284,4554,1973,9351,2123,8425,2009,926,807,551,573,375,533,2220,1209,3261,1655
40015,23144,3482,12230,2349,4015,1642,6142,1467,5289,1356,853,577,217,320,636,493,467,422,1606,841,10914,2040,2521,1116,5235,1181,4672,1124,563,480,282,351,281,365,1454,782,1704,929
40017,109794,21563,54208,13210,16220,8533,30383,7570,27618,6717,2765,3022,938,1616,1827,2354,1327,1861,6278,4772,55586,12583,13168,7304,30012,7467,27053,6425,2959,3488,963,1629,1996,2763,4514,3477,7892,5260
40019,38248,6708,18409,4053,5268,2594,9550,2394,8644,2240,906,903,398,630,508,689,885,849,2706,1695,19839,4017,4397,2276,10095,2564,9161,2396,934,965,441,704,493,703,2370,1479,2977,1656
40021,39664,7528,19370,4606,7081,3309,9139,2407,8404,2285,735,812,307,533,428,584,593,653,2557,1623,20294,4628,6591,3135,8871,2397,8193,2260,678,758,298,495,380,584,2012,1345,2820,1666
40023,11769,1911,5593,1152,1574,736,2913,762,2638,685,275,299,93,167,182,266,334,288,772,423,6176,1126,1467,654,2977,739,2688,685,289,292,99,180,190,243,934,497,798,457
40025,1707,312,822,174,178,104,519,141,496,143,23,32,5,27,18,38,39,35,86,63,885,180,156,90,501,144,477,139,24,39,16,36,8,31,115,67,113,77
40027,229332,46420,113733,28977,42556,21214,57253,16459,52573,15125,4680,5479,1640,3207,3040,4296,2629,3518,11295,8359,115599,27535,34488,17817,57407,16423,53505,15376,3902,5093,1595,3176,2307,3816,8394,6705,15310,10364
40029,4450,592,2195,346,617,222,1143,236,1096,234,47,58,22,45,25,56,115,90,320,146,2255,373,397,144,1155,239,1033,231,122,92,62,70,60,61,390,216,313,141
40031,97306,21566,50659,13437,19274,9237,23803,7564,20681,6787,3122,3083,923,1659,2199,2319,1619,1925,5963,4508,46647,12152,12592,7506,22131,7003,19417,6360,2714,2828,1314,1896,1400,1900,4923,3711,7001,4808
40033,4772,902,2385,499,736,329,1302,361,1193,354,109,106,59,86,50,80,121,108,226,142,2387,544,427,247,1341,373,1182,334,159,152,79,104,80,108,250,145,369,237
40035,11764,1572,6057,1061,1937,761,2995,657,2684,591,311,250,119,154,192,178,221,195,904,411,5707,847,1192,531,3005,600,2833,574,172,197,96,141,76,140,725,347,785,333
40037,57358,6978,28103,4361,7761,2936,15902,2891,14783,2687,1119,1040,480,676,639,838,1056,970,3384,1756,29255,4233,5997,2464,15673,2765,14281,2569,1392,1145,744,821,648,826,3242,1623,4343,1938
40039,22965,6100,11350,3653,4025,2361,5646,2168,5290,2048,356,512,91,283,265,447,390,576,1289,1149,11615,3600,3438,2227,5294,2084,4827,1957,467,684,140,338,327,564,1204,888,1679,1264
40041,35339,5525,17254,3161,4294,1782,9913,2148,9080,1957,833,784,261,376,572,685,881,759,2166,1122,18085,3225,3330,1577,9823,2114,9017,1975,806,671,420,481,386,456,2377,1225,2555,1329
40043,3798,605,1889,347,467,220,1191,248,1093,235,98,89,51,72,47,58,46,56,185,112,1909,358,370,175,1071,220,1031,219,40,53,22,53,18,49,160,102,308,174
40045,3235,341,1577,179,367,128,901,140,837,136,64,45,26,32,38,33,67,46,242,96,1658,223,298,111,905,151,815,146,90,54,29,35,61,51,273,108,182,70
40047,48803,12439,24238,7273,7778,4764,13137,4474,12159,4207,978,1287,288,722,690,1037,757,933,2566,2062,24565,6952,5625,3759,12513,4130,11651,3976,862,1183,342,780,520,897,3165,2430,3262,2403
40049,22088,3182,10838,2009,3164,1392,6101,1399,5561,1288,540,548,257,344,283,424,485,451,1088,680,11250,1905,2389,1114,6005,1355,5483,1320,522,488,331,412,191,347,1339,745,1517,782
40051,44155,6396,21893,3925,6051,2693,12766,2612,12119,2538,647,697,259,502,388,580,620,709,2456,1487,22262,3890,4564,2260,12430,2540,11679,2456,751,779,270,481,481,645,2108,1320,3160,1728
40053,3526,429,1784,254,485,175,1039,190,974,182,65,64,27,40,38,43,83,56,177,89,1742,257,339,128,1015,192,968,180,47,51,26,41,21,41,218,98,170,96
40055,4866,943,2905,622,1023,379,1317,432,985,375,332,190,150,136,182,127,115,118,450,244,1961,513,383,236,934,313,884,305,50,75,29,57,21,65,294,187,350,223
40057,2152,159,1067,99,327,90,608,104,568,110,40,31,26,26,14,17,22,22,110,50,1085,102,182,64,640,114,592,119,48,31,27,23,21,29,128,53,135,54
40059,2942,401,1493,224,417,123,929,205,701,171,228,157,45,46,183,147,35,28,112,74,1449,217,202,91,909,173,801,162,108,61,19,31,89,57,197,98,141,84
40061,10179,1301,4976,798,1181,454,2985,547,2743,526,242,190,133,131,109,151,158,150,652,307,5203,729,828,333,2960,549,2701,506,259,204,137,129,122,149,667,278,748,315
40063,10968,1632,5884,1154,2467,842,2355,565,2009,490,346,287,151,206,195,205,234,200,828,419,5084,937,1182,536,2364,573,2109,521,255,228,135,170,120,158,781,411,757,382
40065,19677,4492,9801,2702,3269,1724,5364,1703,4940,1594,424,524,185,367,239,387,360,405,808,651,9876,2626,2332,1490,5421,1638,4902,1564,519,588,302,429,217,378,888,676,1235,849
40067,4911,612,2467,381,630,238,1401,259,1231,245,170,113,66,80,104,87,114,82,322,139,2444,340,438,165,1274,244,1149,234,125,97,68,81,57,63,359,148,373,144
40069,8871,1186,4353,746,1262,485,2289,508,2049,485,240,180,161,157,79,98,131,147,671,329,4518,774,892,401,2321,544,2143,529,178,157,76,97,102,112,584,299,721,334
40071,35142,5231,17276,3253,5195,2128,8962,2070,8333,1976,629,681,253,473,376,552,595,598,2524,1390,17866,3144,4127,1852,8714,2000,7920,1905,794,753,388,534,406,556,2097,1239,2928,1504
40073,12140,2391,6061,1499,1740,995,3496,959,3159,917,337,337,115,197,222,281,234,261,591,464,6079,1440,1199,695,3523,999,3020,893,503,496,372,436,131,218,791,503,566,419
40075,7134,1270,3549,688,1107,450,1735,475,1629,460,106,135,41,102,65,114,150,158,557,331,3585,786,619,365,1986,542,1697,497,289,237,199,197,90,131,464,272,516,294
40077,8533,1005,4324,658,1078,420,2483,499,2280,473,203,153,81,95,122,124,205,166,558,266,4209,561,864,328,2279,423,2076,394,203,147,105,97,98,113,507,221,559,234
40079,39915,5503,19893,3334,5266,2051,10705,2198,9625,1964,1080,888,443,507,637,713,721,638,3201,1443,20022,3237,3973,1599,10492,2072,9412,1915,1080,827,546,555,534,584,2456,1340,3101,1397
40081,27920,3702,13798,2164,3633,1365,7862,1397,7301,1331,561,502,248,322,313,373,592,450,1711,818,14122,2233,2933,1237,7772,1400,7259,1335,513,468,235,300,278,370,1703,834,1714,805
40083,37761,9210,18531,5228,5699,3204,10192,2963,9458,2776,734,969,299,607,435,727,542,732,2098,1846,19230,5492,4968,3136,9967,3109,9158,2783,809,1077,415,717,394,698,1812,1447,2483,1841
40085,8003,1025,4018,622,1199,403,1977,379,1771,347,206,172,49,77,157,163,198,145,644,279,3985,612,920,326,2043,390,1855,359,188,143,52,80,136,129,501,243,521,258
40087,30930,4245,15174,2581,3494,1559,9762,1834,9321,1789,441,504,96,258,345,449,425,461,1493,901,15756,2529,2993,1513,9444,1767,8927,1717,517,542,260,388,257,395,1517,867,1802,945
40089,25979,4166,12711,2527,3617,1591,6852,1724,6409,1647,443,480,206,362,237,365,482,478,1760,969,13268,2393,2964,1385,6771,1642,6106,1560,665,608,348,458,317,437,1653,919,1880,1021
40091,16500,3102,8098,1859,1906,1049,4697,1303,4358,1268,339,415,237,368,102,233,326,370,1169,766,8402,1815,1491,930,4405,1243,4125,1208,280,388,133,256,147,312,1299,740,1207,777
40093,6011,778,2954,486,630,268,1905,363,1843,365,62,81,28,75,34,70,154,126,265,168,3057,459,472,253,1919,372,1848,369,71,101,29,78,42,84,377,189,289,155
40095,13332,1893,6601,1158,1679,667,3780,780,3355,717,425,328,170,202,255,278,258,242,884,446,6731,1030,1208,555,3617,791,3290,731,327,291,164,192,163,208,810,396,1096,508
40097,33117,5081,16378,3104,4160,1869,9432,2053,8782,1973,650,641,342,461,308,444,485,547,2301,1205,16739,2893,3092,1490,9586,2074,8853,1968,733,697,409,513,324,474,1644,1009,2417,1263
40099,11276,2318,5611,1386,1391,780,3123,977,2844,941,279,298,97,177,182,250,180,241,917,643,5665,1384,1120,699,3119,1017,2653,910,466,459,240,332,226,295,671,515,755,544
40101,54690,9643,26353,5890,7791,3610,14035,3829,12739,3592,1296,1340,603,1000,693,936,1053,1181,3474,2156,28337,5912,6715,3565,14161,3789,12494,3475,1667,1518,911,1086,756,1037,3266,2022,4195,2368
40103,9010,1655,4436,985,1052,525,2628,705,2455,661,173,190,66,117,107,162,179,181,577,393,4574,977,721,406,2859,765,2605,708,254,282,165,225,89,158,447,311,547,389
40105,8353,1181,4079,734,976,444,2366,500,2226,492,140,157,60,121,80,127,110,134,627,334,4274,715,888,437,2302,486,2139,455,163,175,108,155,55,116,575,314,509,308
40107,9731,1575,5300,1124,1907,673,2461,552,2068,498,393,253,136,169,257,192,206,161,726,494,4431,823,954,447,2408,550,2093,475,315,259,181,184,134,174,540,283,529,317
40109,616362,141149,298103,85801,108319,59402,146483,48619,132135,43720,14348,18014,6299,12048,8049,13386,8202,12235,35099,27989,318259,84664,95184,53868,149093,48841,133507,43924,15586,19009,8264,13459,7322,12933,27103,22093,46879,32226
40111,31157,5009,15180,3010,5106,2038,7297,1955,6671,1835,626,678,363,552,263,475,666,650,2111,1272,15977,3050,3882,1843,7335,1925,6577,1796,758,791,350,532,408,592,2035,1167,2725,1403
40113,38739,5401,19334,3315,5401,2125,10968,2187,10164,2093,804,669,366,506,438,495,910,727,2055,1094,19405,3195,3976,1904,10639,2127,9800,1993,839,768,495,568,344,528,2271,1290,2519,1308
40115,24928,2236,12050,1424,3746,1021,6124,914,5664,881,460,325,228,219,232,256,556,351,1624,599,12878,1485,2990,924,6474,917,5774,834,700,413,373,299,327,317,1442,569,1972,633
40117,13212,1492,6534,942,1743,653,3732,640,3482,610,250,227,108,169,142,180,290,232,769,367,6678,910,1389,529,3687,628,3435,599,252,206,140,165,112,157,749,357,853,372
40119,68668,14935,35140,10348,17439,8331,14572,4550,13182,4112,1390,1547,343,773,1047,1319,739,1090,2390,1886,33528,8715,13246,6243,14445,4559,13264,4221,1181,1416,527,958,654,1051,2484,2016,3353,2423
40121,35959,5438,18288,3391,5153,2124,9798,2353,8916,2182,882,837,318,525,564,691,603,641,2734,1416,17671,3161,3203,1706,9611,2258,8940,2172,671,694,402,553,269,500,2393,1394,2464,1332
40123,30813,4856,14971,2944,5040,2143,7719,1871,7107,1749,612,643,262,440,350,504,427,539,1785,1039,15842,2967,4396,2021,7623,1810,7005,1734,618,648,262,416,356,535,1562,977,2261,1205
40125,57960,8158,27300,5056,7799,3285,14637,3132,13620,2990,1017,1028,419,699,598,833,936,897,3928,2073,30660,4982,7615,3106,14768,3164,13241,2928,1527,1267,796,942,731,861,3449,1906,4828,2249
40127,9071,1075,4392,654,1070,399,2550,450,2402,432,148,124,68,85,80,97,216,162,556,239,4679,625,807,304,2578,466,2374,447,204,147,98,103,106,108,705,273,589,241
40129,2864,373,1383,207,350,139,744,162,672,154,72,56,53,46,19,26,61,44,228,95,1481,224,267,127,826,148,764,149,62,50,41,43,21,25,206,89,182,102
40131,73737,7207,36385,4662,9453,3241,21904,3226,20842,3090,1062,991,489,682,573,743,1122,1009,3906,1770,37352,4270,7475,2648,22435,3150,21125,3105,1310,1094,654,743,656,793,3166,1581,4276,1829
40133,19743,2813,9551,1711,2783,1129,4876,1097,4449,1037,427,403,187,297,240,319,419,368,1473,753,10192,1747,2280,972,4973,1095,4467,1026,506,432,192,298,314,351,1437,747,1502,721
40135,33605,4794,16379,2947,4525,1854,8823,1915,8141,1800,682,666,263,404,419,522,734,639,2297,1237,17226,2822,3382,1541,9005,1942,8161,1823,844,768,480,542,364,505,2028,1102,2811,1328
40137,35313,5563,16973,3282,4398,2210,9373,2149,8796,2070,577,694,223,449,354,542,855,790,2347,1375,18340,3568,3677,2030,9927,2245,8962,2077,965,851,430,604,535,642,2354,1278,2382,1382
40139,15780,4539,8543,3021,3191,1917,4509,1883,3991,1649,518,646,124,257,394,593,273,390,570,596,7237,2347,1903,1233,3695,1489,3390,1361,305,424,79,228,226,397,667,597,972,825
40141,5965,1139,3066,759,950,505,1668,487,1457,430,211,214,98,171,113,151,101,129,347,239,2899,618,602,342,1502,413,1341,396,161,182,105,160,56,117,396,230,399,246
40143,509150,63646,245164,41597,83282,30627,126393,26449,115481,24685,10912,10288,4417,6706,6495,8232,6745,7982,28744,16359,263986,40395,73240,27656,127872,26739,116457,24953,11415,10516,5600,7222,5815,7945,22665,14127,40209,19187
40145,63024,6541,30915,4156,7908,2763,18470,2849,17671,2761,799,847,278,567,521,704,968,888,3569,1722,32109,4061,6588,2457,18310,2787,17160,2672,1150,986,612,717,538,729,2959,1580,4252,1833
40147,41585,6491,19999,4158,5416,2703,11566,2787,10746,2623,820,946,360,676,460,659,671,818,2346,1575,21586,3975,4066,2226,11687,2784,10674,2604,1013,1107,516,793,497,772,2359,1489,3474,1965
40149,8888,1339,4385,810,1155,457,2526,566,2400,543,126,139,65,100,61,109,142,152,562,293,4503,774,849,372,2581,545,2331,513,250,198,176,186,74,98,452,286,621,276
40151,7467,1672,3968,1078,1614,794,1773,642,1574,577,199,212,65,131,134,185,123,173,458,359,3499,978,1053,615,1735,622,1539,545,196,227,87,150,109,182,379,312,332,291
40153,16301,4064,8712,2415,2755,1496,4678,1672,4329,1572,349,432,108,260,241,358,220,331,1059,789,7589,2235,1337,1028,4547,1584,4190,1476,357,496,120,287,237,401,783,684,922,770
41001,13417,2726,6861,1691,1666,982,3993,1178,3602,1106,391,447,131,303,260,331,265,277,937,617,6556,1533,1086,776,3761,1103,3464,1048,297,383,76,231,221,361,825,584,884,579
41003,79029,14502,39621,9583,18037,7756,18190,4727,17305,4586,885,1359,270,950,615,1145,809,1215,2585,2137,39408,9029,15717,6900,17901,4808,16824,4539,1077,1523,534,1148,543,1106,1916,1840,3874,2608
41005,337765,60011,164945,36713,48386,24268,95465,23126,90683,22003,4782,6272,1704,4073,3078,4908,3288,4915,17806,12741,172820,34420,40400,20737,95895,22802,90368,21800,5527,6809,2401,4451,3126,5167,13759,9933,22766,13822
41007,32957,7299,16275,4487,4937,2847,8388,2804,7687,2636,701,894,264,642,437,724,455,724,2495,1884,16682,4218,3690,2383,8400,2692,7809,2574,591,847,210,575,381,726,1631,1367,2961,1916
41009,42522,9281,21213,5362,6229,3416,11527,3362,10617,3116,910,1141,370,738,540,859,733,971,2724,1872,21309,5297,4782,2908,11113,3298,10263,2997,850,1088,321,675,529,869,2111,1671,3303,2123
41011,54014,15017,26483,8890,7122,4991,14108,5617,13057,5214,1051,1693,439,1140,612,1319,1289,1814,3964,3375,27531,8347,5953,4375,13606,5446,12601,5106,1005,1522,590,1164,415,1106,3291,2815,4681,3623
41013,19326,4195,9505,2341,2426,1333,5482,1643,5166,1559,316,471,80,244,236,404,397,486,1200,882,9821,2454,2000,1377,5596,1662,5318,1596,278,425,170,323,108,292,906,656,1319,1001
41015,19873,4756,9781,2778,2065,1362,5665,2039,5438,1986,227,378,70,234,157,328,323,451,1728,1193,10092,2723,1572,1185,5083,1818,4748,1752,335,474,111,298,224,380,1344,1008,2093,1469
41017,154982,31155,75963,18994,22162,12261,42722,11916,40377,11445,2345,3001,870,1862,1475,2446,1791,2497,9288,6924,79019,17817,17289,9928,43499,11959,40897,11558,2602,3202,951,1903,1651,2534,5866,4624,12365,7530
41019,91720,21058,44943,12482,11938,7190,25125,8298,23534,7890,1591,2198,741,1534,850,1699,1389,1917,6491,4762,46777,12128,9110,6012,25273,8224,23162,7762,2111,2611,1185,1998,926,1739,5463,4304,6931,4925
41021,1578,268,755,146,231,91,394,117,369,111,25,36,0,36,25,36,2,27,128,67,823,171,129,73,401,116,369,113,32,37,15,38,17,31,113,77,180,97
41023,6149,1244,3101,733,634,297,1885,548,1748,522,137,145,65,91,72,125,205,199,377,262,3048,684,566,300,1730,506,1643,498,87,127,33,65,54,126,337,230,415,257
41025,6042,1236,3044,719,712,379,1882,550,1796,530,86,124,53,93,33,86,73,103,377,241,2998,697,511,327,1827,541,1652,534,175,165,58,100,117,137,333,232,327,255
41027,18641,5383,9323,3470,3061,2183,5244,2098,4737,1813,507,786,53,251,454,759,258,449,760,758,9318,2680,2252,1517,5297,1959,4812,1816,485,671,103,316,382,601,587,557,1182,1035
41029,179188,37362,86521,22085,25477,13953,47351,14160,44607,13641,2744,3797,1067,2442,1677,2948,3024,3719,10669,7650,92667,21808,21740,12519,47474,14254,43845,13364,3629,4539,1777,3090,1852,3190,8485,6399,14968,8855
41031,18938,3526,9818,2202,3545,1409,4530,1361,4035,1246,495,407,173,286,322,332,338,345,1405,838,9120,1966,2452,1107,4559,1292,4097,1204,462,457,170,287,292,374,668,536,1441,825
41033,72305,15547,35075,9152,9563,5297,19533,5895,18397,5672,1136,1563,424,1010,712,1240,1332,1693,4647,3569,37230,8979,7014,4603,20512,6210,18422,5682,2090,2355,992,1540,1098,1544,3908,2844,5796,3862
41035,54806,14161,27248,8482,8010,4938,14375,5346,13548,5118,827,1358,470,1166,357,1009,1191,1574,3672,2971,27558,7815,6371,4238,14207,5174,13108,4911,1099,1505,473,1117,626,1160,2595,2161,4385,3133
41037,6637,1440,3601,853,1014,498,1854,574,1640,565,214,199,115,179,99,140,122,161,611,351,3036,820,551,351,1761,580,1612,554,149,180,87,139,62,121,319,265,405,318
41039,316180,63489,154390,39917,60204,29802,72455,21560,67404,20303,5051,6900,1978,4643,3073,5473,3707,5406,18024,12982,161790,37371,49956,24726,74508,21791,68923,20713,5585,6981,3000,5238,2585,4858,12828,9790,24498,15028
41041,41721,8368,19952,4798,5487,2841,10856,3225,9828,3002,1028,1121,458,796,570,876,619,798,2990,1971,21769,4759,4544,2394,10935,3203,10149,3047,786,928,312,634,474,714,2382,1644,3908,2202
41043,101647,23519,49619,13758,15201,8769,26745,8616,25272,8317,1473,2097,511,1400,962,1735,1556,2078,6117,4784,52028,13486,12616,7545,27373,8777,25230,8283,2143,2595,1139,1931,1004,1768,4684,3738,7355,5243
41045,23929,5230,13334,3227,5271,2206,5528,1897,4622,1728,906,722,292,570,614,578,439,566,2096,1080,10595,2852,2838,1645,5351,1883,4858,1758,493,654,261,506,232,477,1017,775,1389,1021
41047,269334,59236,133187,35980,46786,23744,67371,21126,60173,18990,7198,7866,2170,4070,5028,6461,3711,5017,15319,11594,136147,33018,37370,20628,67179,20303,60907,18983,6272,7219,2977,4832,3295,5120,10893,8720,20705,12700
41049,8748,1748,4421,1043,1345,630,2692,735,2463,704,229,244,48,154,181,211,110,156,274,225,4327,945,909,498,2753,764,2608,771,145,165,85,179,60,111,352,325,313,250
41051,675534,134297,332460,85028,143108,64938,147850,47365,135761,43812,12089,15777,4470,10079,7619,12528,5639,10166,35863,26802,343074,79869,124588,56999,148981,46648,134944,43222,14037,16408,6065,10870,7972,12511,21233,18628,48272,30865
41053,67527,12298,32679,7695,10477,5135,18049,4678,16872,4435,1177,1354,436,802,741,1074,865,1087,3288,2416,34848,7369,9916,4665,18111,4590,16909,4344,1202,1380,451,800,751,1096,2324,1773,4497,2873
41055,1420,163,767,109,220,59,361,69,324,60,37,31,13,14,24,25,35,34,151,65,653,90,110,46,379,60,354,55,25,21,10,13,15,16,73,33,91,39
41057,22091,5486,11035,3201,3044,1963,5913,2172,5479,2054,434,591,237,488,197,437,289,479,1789,1335,11056,3291,2261,1628,5960,2184,5427,2016,533,718,216,484,317,556,1221,963,1614,1323
41059,60810,15570,31910,9217,11548,6156,15596,5761,13753,5271,1843,1821,468,1039,1375,1559,958,1388,3808,2766,28900,8659,7003,4755,15463,5540,13966,5199,1497,1836,706,1311,791,1355,2512,2354,3922,3091
41061,21571,4463,10575,2700,3308,1830,5790,1742,5495,1580,295,559,104,328,191,488,499,542,978,720,10996,2501,2625,1420,5776,1611,5379,1526,397,534,256,479,141,315,1165,855,1430,968
41063,5919,894,2876,505,591,292,1836,383,1733,375,103,104,31,88,72,98,102,103,347,240,3043,540,460,242,1968,436,1794,392,174,197,45,101,129,158,294,190,321,181
41065,21178,4222,10556,2626,3207,1657,5497,1625,4985,1425,512,647,99,305,413,608,405,466,1447,944,10622,2476,2332,1330,5717,1701,5068,1474,649,713,258,404,391,541,1193,735,1380,900
41067,475704,86386,233330,52054,79052,36501,129787,32901,121116,30766,8671,10730,2282,5570,6389,9008,3835,6357,20656,16359,242374,50409,65723,32085,128962,32224,119876,30215,9086,10636,3412,6590,5674,8162,15971,12956,31718,19529
41069,1201,169,598,99,99,54,369,66,338,66,31,26,8,10,23,24,40,29,90,38,603,98,84,45,369,69,347,68,22,21,11,16,11,12,84,38,66,35
41071,85480,15872,42526,9724,13769,6546,22888,5905,20825,5431,2063,1857,492,1019,1571,1562,1284,1547,4585,3016,42954,9153,11449,5928,22552,5747,20827,5393,1725,1925,696,1248,1029,1359,3596,2568,5357,3205
42001,85464,10097,41793,6303,12327,4407,24483,4377,23001,4181,1482,1468,607,913,875,1137,1127,1107,3856,2353,43671,6315,10217,4195,24591,4386,23031,4174,1560,1409,738,957,822,1023,4141,2266,4722,2495
42003,1031724,197915,493335,122938,191170,90678,245159,72651,229087,68517,16072,22585,7217,16492,8855,17339,15358,21131,41648,36576,538389,122066,177879,85674,245408,72081,227679,68185,17729,23823,9877,18456,7852,16588,57347,40667,57755,42203
42005,55448,9214,27429,5371,7576,3235,16241,3713,15352,3571,889,1075,481,820,408,815,1118,1192,2494,1688,28019,5388,5806,2886,15862,3640,14863,3487,999,1086,627,913,372,718,3572,2093,2779,1828
42007,139274,24231,66898,14478,21171,9685,36295,9220,34067,8860,2228,2723,1229,2086,999,1936,2435,2832,6997,5116,72376,14801,18462,9274,36858,9469,34414,8896,2444,3048,1576,2462,868,1928,8656,5593,8400,5642
42009,40653,6298,20045,3683,5320,2350,11974,2492,11179,2347,795,850,424,602,371,611,736,660,2015,1265,20608,3617,3960,1935,11766,2411,11115,2331,651,667,342,491,309,493,2786,1542,2096,1252
42011,341000,62963,166217,37822,58332,26441,87503,22882,80439,21327,7064,7957,3333,5347,3731,5554,5346,6268,15036,11543,174783,37601,52142,24898,86924,22759,78897,20615,8027,8576,4679,6261,3348,5409,16719,11303,18998,12996
42013,102456,21158,49529,12729,15767,8283,27292,8247,25240,7753,2052,2579,1190,2001,862,1754,1650,2106,4820,3978,52927,12201,13553,7428,26637,8029,24480,7586,2157,2518,1322,2009,835,1662,6558,4285,6179,4419
42015,49764,8451,24456,4925,6701,2907,13884,3220,13024,3124,860,877,388,647,472,694,1143,1027,2728,1686,25308,4912,5904,2885,14024,3293,13012,3079,1012,1029,534,753,478,764,2674,1576,2706,1717
42017,522873,89271,254531,53222,78528,35981,150091,34537,141212,33084,8879,10590,3539,6587,5340,8243,6954,8550,18958,15377,268342,53302,67574,33333,148116,33977,139317,32564,8799,10076,4572,7361,4227,7038,25800,17253,26852,18091
42019,156212,22262,76850,13885,22977,9669,44821,8750,42838,8520,1983,2358,983,1735,1000,1707,2377,2592,6675,4551,79362,13265,19215,7947,45079,8796,43077,8504,2002,2453,1248,2011,754,1589,7596,4538,7472,4842
42021,112102,18684,54712,11684,19043,8426,28562,7223,26614,6775,1948,2283,966,1794,982,1739,1814,2098,5293,3812,57390,10978,15574,7069,28396,7099,26611,6787,1785,2201,1192,1894,593,1527,7813,4333,5607,3944
42023,4013,637,1939,370,598,253,960,235,909,222,51,76,21,58,30,68,109,91,272,145,2074,408,455,224,996,234,975,228,21,51,13,49,8,55,272,132,351,215
42025,53785,10997,26645,6481,8610,4376,13989,4183,12996,4031,993,1275,552,950,441,861,1056,1318,2990,2339,27140,6409,6730,3868,13899,4167,12884,3999,1015,1255,529,910,486,905,3225,2310,3286,2353
42027,141981,24988,74885,16911,38255,13946,30330,7943,28209,7319,2121,2441,555,1363,1566,2073,1516,2062,4784,3733,67096,15563,27904,12116,28910,7527,27386,7101,1524,2115,589,1405,935,1699,4731,3662,5551,4152
42029,422314,61338,206386,39164,66244,28868,121415,23960,114493,22519,6922,7790,2516,4703,4406,6019,4709,5781,14018,11190,215928,37257,59519,25971,119014,23169,112577,22116,6437,7333,3189,5261,3248,5098,16814,11184,20581,13168
42031,32688,4867,15783,2949,5350,2052,8387,1720,7939,1659,448,471,260,390,188,326,514,464,1532,966,16905,3168,4883,2186,8530,1763,8056,1698,474,492,303,435,171,354,1930,1071,1562,945
42033,67690,10500,35607,6399,12154,4478,17980,4174,15973,3923,2007,1358,883,989,1124,1019,1349,1339,4124,2321,32083,6127,6728,3397,17246,4103,16234,3947,1012,1183,570,904,442,865,4163,2411,3946,2436
42035,32384,5473,15898,3155,5564,2228,8211,1957,7580,1805,631,711,145,386,486,641,536,610,1587,1023,16486,3538,5141,2481,7815,1810,7304,1761,511,610,253,454,258,492,1716,1024,1814,1132
42037,56151,10201,26735,6109,10052,4391,13329,3410,12384,3228,945,1101,357,707,588,951,850,1007,2504,1761,29416,6263,9565,4124,13175,3417,12399,3281,776,1002,511,830,265,645,2916,1839,3760,2444
42039,71052,11375,34230,6776,10262,4363,18880,4466,17719,4262,1161,1343,634,1030,527,968,1313,1379,3775,2402,36822,6900,9717,4250,19123,4488,17897,4336,1226,1259,728,1074,498,870,3610,2283,4372,2603
42041,207506,32409,102052,20255,34558,14328,56288,13242,52121,12589,4167,4103,1977,3021,2190,2842,2753,3380,8453,6410,105454,19920,27297,12694,55582,13296,51775,12536,3807,4421,2185,3369,1622,2771,9990,6600,12585,8177
42043,224164,50004,107405,29557,39812,21275,54436,16417,50495,15417,3941,4869,1794,3249,2147,3648,2915,3849,10242,8279,116759,29799,35805,18268,55689,18562,50113,15288,5576,7522,2692,3878,2884,5730,11058,8290,14207,9775
42045,461745,97434,219237,57770,86214,40657,110726,33348,101872,30947,8854,11151,3793,7497,5061,8312,6869,9349,15428,14626,242508,58996,84221,40650,111650,33286,101351,30594,10299,12268,5580,8887,4719,8350,22920,16952,23717,18032
42047,25557,3817,12858,2457,4022,1738,6965,1682,6592,1602,373,477,238,417,135,322,551,562,1320,983,12699,2197,2732,1419,7209,1697,6869,1664,340,415,214,344,126,299,1414,892,1344,900
42049,225437,44455,110419,27143,42412,19622,53043,15955,48981,14897,4062,5079,2157,3882,1905,3618,4251,5181,10713,8463,115018,27099,35441,17919,54760,16405,49656,15171,5104,6221,3563,5231,1541,3447,11367,8508,13450,9640
42051,110627,19791,54371,12008,18373,8306,28099,7585,25594,7170,2505,2535,1188,1727,1317,1795,1850,2125,6049,4279,56256,11740,14322,7022,27716,7402,25403,6993,2313,2499,1415,1953,898,1497,7776,4644,6442,4175
42053,6811,770,5056,547,2913,382,1289,317,824,260,465,146,124,98,341,132,179,135,675,231,1755,381,171,172,1119,316,1055,317,64,82,39,73,25,63,275,136,190,128
42055,125668,23135,61119,13782,17940,9002,35796,9140,33936,8683,1860,2338,981,1714,879,1589,1958,2368,5425,4267,64549,13422,14638,7751,36012,9045,34159,8636,1853,2414,1075,1861,778,1510,6214,4192,7685,5217
42057,12121,1302,6093,779,1766,506,3493,502,3339,495,154,118,49,93,105,111,208,152,626,276,6028,750,1261,435,3531,503,3281,482,250,181,130,134,120,128,699,260,537,254
42059,30988,5776,16132,3497,5426,2071,8248,2301,7407,2102,841,775,393,582,448,547,616,682,1842,1108,14856,3475,3762,2103,7712,2130,7283,2068,429,520,313,483,116,344,1695,1148,1687,1180
42061,38627,5108,20716,3144,7678,2104,10352,1983,9231,1805,1121,665,381,442,740,585,633,580,2053,1104,17911,3004,4174,1732,10001,1889,9488,1843,513,487,289,410,224,330,1911,997,1825,1076
42063,72494,12892,36107,7984,13855,5980,18282,4259,17049,4125,1233,1391,589,1010,644,1008,766,988,3204,2253,36387,7687,11492,5236,18111,4308,17028,4129,1083,1347,607,1050,476,931,3686,2210,3098,2196
42065,36169,5279,17891,3099,5156,1971,10244,2062,9786,2004,458,535,228,440,230,461,599,590,1892,1116,18278,3116,3988,1827,10068,2059,9443,1938,625,658,421,546,204,478,2037,1111,2185,1211
42067,20128,3269,10032,1860,2813,1124,5725,1181,5395,1136,330,382,190,331,140,238,516,449,978,596,10096,1849,2283,1003,5478,1147,5166,1112,312,300,141,213,171,255,1205,704,1130,680
42069,175220,36767,83830,21527,30937,14979,41950,13206,39097,12545,2853,3776,1154,2565,1699,2995,3116,3985,7827,6367,91390,22488,28038,14293,42033,13261,38512,12318,3521,4306,2061,3300,1460,2852,10760,7624,10559,7548
42071,434487,80460,210331,48310,66753,33894,121944,30298,114833,28742,7111,8849,2943,5781,4168,6693,6178,7763,15456,13465,224156,47914,60169,31544,122843,30031,114856,28647,7987,9423,3996,6715,3991,6416,19927,14245,21217,15757
42073,72624,12505,34838,7544,10861,5035,18993,4839,18001,4615,992,1341,596,1108,396,967,1224,1427,3760,2668,37786,7387,9346,4415,19446,4824,18070,4586,1376,1518,886,1234,490,1013,4680,2871,4314,2702
42075,113132,19178,54925,11647,17725,8347,30146,7273,28380,6886,1766,2266,731,1446,1035,1776,1959,2094,5095,3841,58207,11447,14517,7233,30375,7178,28418,6850,1957,2360,1147,1794,810,1503,6091,3899,7224,4600
42077,297041,61260,143373,36105,52304,25676,74359,21633,69250,20502,5109,6498,2635,4799,2474,4420,3679,5257,13031,11039,153668,36004,48154,24342,75064,21564,67877,19857,7187,7900,4268,6042,2919,4799,14480,10258,15970,11380
42079,266532,53691,131017,32572,49518,22882,63958,19523,58593,18338,5365,6195,2344,4288,3021,4797,4497,5486,13044,10095,135515,31530,40066,20583,64103,19387,57073,17792,7030,7609,3836,5617,3194,5030,16704,10661,14642,10654
42081,94860,18644,46147,11099,15635,7398,24301,6832,22719,6401,1582,2117,983,1745,599,1420,1533,1884,4678,3641,48713,11136,13311,6906,25072,6935,22890,6474,2182,2535,1352,2097,830,1547,4788,3381,5542,3990
42083,34738,5004,17928,3227,6379,2401,9140,2140,8220,1859,920,890,457,589,463,680,504,470,1905,1062,16810,2885,4010,1741,8811,1985,8153,1841,658,651,431,542,227,408,1997,1054,1992,1072
42085,94209,17559,46108,10668,15005,6700,23791,6507,22037,6131,1754,1985,989,1616,765,1381,1904,2197,5408,3713,48101,10336,12372,6107,23801,6519,22047,6147,1754,2038,1078,1700,676,1326,6349,4010,5579,3823
42087,37652,6746,18247,3953,5179,2501,10573,2703,10084,2639,489,698,335,605,154,425,711,847,1784,1356,19405,3900,4176,2218,11032,2790,10455,2734,577,722,323,570,254,511,2170,1364,2027,1422
42089,141774,35125,69793,20480,25961,13987,36203,11414,33251,10788,2952,3481,1485,2385,1467,2239,1945,2764,5684,5029,71981,20509,22530,12406,35139,11145,31596,10246,3543,4109,1994,2902,1549,2516,6995,5703,7317,6031
42091,677140,114098,325554,68885,106231,48373,189261,43887,178854,41777,10407,12862,3795,8424,6612,10321,8012,10745,22050,18832,351586,68173,96202,44578,188907,43224,178667,41456,10240,13004,5397,9545,4843,9243,32792,21842,33685,23134
42093,15244,2318,7195,1320,2395,948,3836,807,3659,776,177,232,40,144,137,201,203,205,761,510,8049,1496,2206,993,3955,893,3676,806,279,331,91,179,188,258,1035,612,853,501
42095,253608,47526,123700,28392,43650,19857,66345,17328,61941,16419,4404,5479,2257,3917,2147,3683,3225,4256,10480,8474,129908,28068,37897,18367,65489,17279,60944,16187,4545,5548,2956,4420,1589,3242,12929,8982,13593,9538
42097,76972,15275,38574,8876,13057,6006,20429,5814,19080,5656,1349,1553,645,1291,704,1100,1496,1745,3592,2846,38398,9007,8856,5150,20303,5908,18888,5633,1415,1813,835,1485,580,1224,4902,3125,4337,3314
42099,37886,4841,19070,2791,5250,1867,11230,1995,10548,1899,682,633,316,436,366,473,522,523,2068,1090,18816,2841,3920,1660,11100,1982,10527,1881,573,611,364,509,209,381,1865,1012,1931,1027
42101,1285938,392950,598094,233594,318760,179846,215351,108858,177831,92501,37520,48143,16556,30013,20964,34121,16408,28273,47575,52825,687844,240278,332733,178547,220625,109129,174782,89978,45843,52792,26233,37898,19610,32575,62993,56880,71493,64187
42103,47693,10461,24054,6123,7293,3750,13572,4053,12601,3865,971,1161,330,711,641,926,919,1092,2270,1937,23639,5997,5956,3301,12964,3952,12106,3803,858,1082,408,659,450,839,2513,1879,2206,1746
42105,13938,1637,6920,949,2056,604,3771,581,3496,545,275,221,125,140,150,177,333,241,760,336,7018,970,1435,492,3810,608,3481,528,329,284,104,135,225,249,918,365,855,365
42107,119546,21887,61075,13108,21435,8801,30988,8692,28254,8151,2734,2790,1325,2099,1409,1998,2139,2402,6513,4593,58471,12990,13807,7293,30182,8634,28070,8110,2112,2635,1313,2098,799,1796,7732,4776,6750,4685
42109,33489,4887,16481,2943,5098,1915,9436,1871,8941,1816,495,521,278,427,217,374,514,554,1433,931,17008,2840,4643,1737,9105,1842,8582,1756,523,548,253,365,270,453,1621,957,1639,982
42111,63355,9956,33174,6031,10466,3812,17699,3991,16146,3795,1553,1191,691,927,862,892,1181,1182,3828,2214,30181,5597,6122,3081,16869,3834,16103,3738,766,995,459,864,307,710,4014,2308,3176,2137
42113,5601,769,2972,457,913,366,1521,264,1320,225,201,144,95,88,106,92,131,92,407,161,2629,396,487,223,1401,218,1262,207,139,97,52,56,87,74,382,149,359,150
42115,34711,4969,17423,2786,5122,1745,9678,1816,9072,1783,606,508,313,389,293,374,545,516,2078,1037,17288,2828,3526,1492,9736,1849,9106,1785,630,561,348,458,282,415,2113,1039,1913,965
42117,34275,4536,16839,2680,5007,1865,9333,1741,8593,1628,740,641,422,471,318,460,688,565,1811,931,17436,2721,4180,1695,9331,1776,8490,1612,841,764,489,583,352,472,2020,992,1905,977
42119,38646,6671,21428,4511,9377,3525,9716,2527,8167,2164,1549,890,537,641,1012,637,580,696,1755,1225,17218,3494,4833,2152,8655,2252,8237,2169,418,599,110,328,308,542,1938,1186,1792,1270
42121,43594,7161,21371,4353,6008,2713,11877,2695,11075,2586,802,862,503,725,299,552,797,854,2689,1650,22223,4154,4677,2269,12032,2738,11166,2589,866,945,410,642,456,735,2420,1467,3094,1763
42123,33510,5262,16744,3112,4524,1934,9718,2246,9031,2127,687,739,378,569,309,554,689,649,1813,1050,16766,3102,3474,1715,9316,2129,8752,2066,564,636,289,505,275,498,2075,1136,1901,1191
42125,173825,29397,84685,17630,27009,12133,46896,11379,44386,10889,2510,3160,1263,2382,1247,2382,2941,3278,7839,5896,89140,17675,21952,11021,47229,11391,44583,11004,2646,3281,1526,2558,1120,2341,9515,6130,10444,6759
42127,44536,8494,23656,5099,8203,3192,11968,3186,10596,2964,1372,1078,520,683,852,838,990,1141,2495,1597,20880,5080,4726,2694,11435,3076,10517,2926,918,1009,492,738,426,681,2477,1790,2242,1685
42129,299677,46302,145491,28395,43195,19307,84312,19265,79875,18500,4437,5438,2234,3853,2203,4017,5150,5625,12834,9273,154186,27586,35293,16564,84205,19043,79737,18376,4468,5297,2637,4117,1831,3514,17754,10521,16934,10661
42131,23018,2982,11538,1820,3726,1179,6058,1026,5581,981,477,389,247,278,230,278,488,353,1266,607,11480,1705,2862,1000,5965,1063,5512,1013,453,385,280,304,173,237,1225,605,1428,644
42133,364186,70673,178261,42187,56676,28477,98806,26429,93270,25440,5536,7068,2694,5233,2842,5242,4993,6734,17786,14110,185925,41095,47130,25394,99605,26540,92457,24988,7148,8439,4270,6457,2878,5447,18032,13146,21158,15125
44001,41427,8586,19808,5117,6797,3385,10715,3151,10301,3083,414,697,84,508,330,672,590,787,1706,1590,21619,4850,6501,3054,10746,3196,10203,3086,543,849,137,592,406,754,1869,1376,2503,1746
44003,138445,29128,66253,17189,21429,11617,35456,10872,33875,10553,1581,2767,520,1945,1061,2377,1855,2857,7513,5797,72192,17310,18823,10267,35918,10963,33976,10638,1942,2966,822,2195,1120,2355,7556,5635,9895,6804
44005,71226,13176,34878,8231,12196,5905,18782,5304,17500,4987,1282,1486,260,968,1022,1324,879,1353,3021,2445,36348,8161,10365,5401,17780,4895,16593,4689,1187,1551,411,1063,776,1312,3596,2660,4607,3111
44007,527000,142717,253559,85077,111410,60099,112328,46151,100832,42125,11496,15624,3607,9508,7889,13059,6259,10825,23562,22494,273441,83544,104982,56310,109817,44293,97070,39766,12747,16308,6098,11388,6649,12022,24639,21192,34003,26649
44009,109251,22785,52228,13441,18216,9461,27996,8027,26665,7675,1331,2195,418,1532,913,1891,1148,1807,4868,4045,57023,14339,17495,9645,28277,8052,26965,7805,1312,2172,556,1659,756,1736,4836,3860,6415,4417
45001,20482,5359,9817,3161,3383,2093,5010,1910,4493,1752,517,612,221,409,296,482,415,577,1009,927,10665,3127,2831,1767,5272,2021,4568,1776,704,840,531,715,173,393,1476,1108,1086,935
45003,138224,33090,65804,19212,19451,12297,36844,11886,34201,11145,2643,3466,1271,2579,1372,2493,2738,3514,6771,5700,72420,19625,18924,11616,37388,11699,33746,10824,3642,4338,2137,3248,1505,2706,7341,5740,8767,6755
45005,7663,2403,4107,1450,1909,1017,1563,731,1187,662,376,310,179,239,197,214,148,221,487,305,3556,1344,1318,884,1374,724,1208,657,166,260,138,230,28,147,600,459,264,264
45007,160570,35876,76470,21244,22080,13235,42996,12932,39521,12036,3475,4508,1671,3072,1804,3146,3148,3939,8246,6905,84100,20839,21269,12345,42944,13086,38920,11973,4024,4693,2679,3782,1345,2709,9208,6604,10679,7534
45009,12026,4485,5763,2389,2489,1695,2709,1501,2399,1408,310,459,223,405,87,255,223,437,342,455,6263,2654,2132,1693,2678,1400,2224,1264,454,533,307,424,147,326,945,860,508,578
45011,17122,4682,8043,2648,3256,1838,3672,1587,3326,1465,346,531,228,447,118,331,410,563,705,711,9079,3025,3073,2062,3749,1594,3242,1416,507,582,310,469,197,398,1182,923,1075,913
45013,156340,33454,76249,20471,23335,13629,44128,12148,41138,11172,2990,4022,1243,2554,1747,3033,2021,2863,6765,5937,80091,19460,18545,11285,45207,12094,40970,11073,4237,4638,1842,2876,2395,3447,7692,5598,8647,6542
45015,171901,30508,84896,18485,28080,12722,46025,11298,41859,10505,4166,4249,2270,2982,1896,2813,2006,2613,8785,6342,87005,18439,23406,11875,46643,11396,41252,10343,5391,4870,3203,3533,2188,2930,6215,4929,10741,6646
45017,12291,3159,5778,1826,1571,1145,3479,1240,2966,1126,513,500,212,298,301,379,193,260,535,488,6513,1856,1734,1186,3319,1202,2951,1126,368,326,213,258,155,256,754,530,706,537
45019,333788,69116,159839,42493,65535,31132,76482,23461,70012,21655,6470,7927,2519,5079,3951,6186,4213,6314,13609,11783,173949,42817,60116,29358,77477,23333,69376,21419,8101,8994,4323,6522,3778,6060,15207,11293,21149,15156
45021,46003,11759,22066,7052,8224,4991,10963,4059,8821,3418,2142,2069,985,1324,1157,1493,713,925,2166,1917,23937,7134,7406,4441,10975,3954,8817,3345,2158,2119,766,1120,1392,1644,2865,2140,2691,2200
45023,26287,6777,12535,3705,4759,2645,6111,2166,5532,2015,579,752,323,588,256,526,653,725,1012,976,13752,4202,4403,2814,6222,2208,5527,2059,695,793,415,641,280,560,1835,1257,1292,1078
45025,37604,9809,18256,5528,6073,3433,9824,3620,8780,3371,1044,1193,571,891,473,755,847,1043,1512,1310,19348,5839,5316,3304,9472,3533,8628,3381,844,993,552,819,292,590,2317,1744,2243,1766
45027,28546,6208,14002,3836,5399,2577,7043,2238,6005,1998,1038,994,682,858,356,527,368,548,1192,1050,14544,3529,4614,2357,6424,2008,5785,1898,639,733,408,601,231,487,2229,1427,1277,1048
45029,30786,8510,14747,4804,4765,3161,7431,2881,6536,2737,895,904,425,677,470,621,667,783,1884,1657,16039,5032,3982,2938,7994,3056,6934,2734,1060,1269,811,1120,249,625,1881,1492,2182,1788
45031,54758,14737,25455,8288,9370,5520,12455,4968,11180,4524,1275,1690,756,1336,519,1104,1011,1421,2619,2494,29303,8895,9494,5558,12597,4890,10854,4413,1743,2024,1195,1711,548,1080,3866,2972,3346,2930
45033,24175,7741,11108,4311,4921,3122,5013,2366,4552,2219,461,663,388,620,73,371,387,607,787,950,13067,4611,5224,3168,5188,2292,4346,2097,842,919,622,773,220,491,1498,1225,1157,1076
45035,125998,24267,60671,14837,21372,10738,32757,8805,30003,8040,2754,3202,1072,1839,1682,2380,1221,1858,5321,4128,65327,14962,19349,9877,32336,8477,28875,7657,3461,3341,1924,2267,1537,2249,5839,4291,7803,5490
45037,23009,4907,12463,3235,4775,2145,5857,1924,4624,1612,1233,844,418,497,815,680,417,467,1414,902,10546,2556,3166,1614,4975,1506,4562,1440,413,544,295,478,118,325,1040,740,1365,908
45039,19046,5440,8918,3267,3413,2255,4469,1800,4019,1736,450,600,169,325,281,500,266,424,770,818,10128,3357,3708,2233,4423,1786,4033,1703,390,562,281,481,109,321,1239,993,758,748
45041,111061,27517,51061,15855,18450,10878,26323,9446,23659,8713,2664,3477,1444,2528,1220,2399,1674,2528,4614,4505,60000,16733,20294,10918,26363,9214,22955,8317,3408,3781,2260,3036,1148,2215,6736,5111,6607,5345
45043,52625,12355,24485,7396,7312,4684,14223,4602,13037,4318,1186,1564,777,1237,409,921,933,1274,2017,1953,28140,7461,7618,4598,13574,4270,12513,4101,1061,1364,624,1063,437,877,3466,2555,3482,2613
45045,408776,71959,195924,44200,65088,30732,106900,25751,98817,24217,8083,8904,3791,6156,4292,6610,4994,6764,18942,14769,212852,43189,60614,28084,108225,26061,98780,23872,9445,9570,5635,7276,3810,6188,19080,13221,24933,16289
45047,56915,13349,25922,8203,9381,5801,12994,4508,11662,4060,1332,1654,810,1267,522,1005,945,1327,2602,2376,30993,8041,10087,5322,13400,4390,11755,4009,1645,1830,1078,1520,567,1042,3509,2591,3997,3014
45049,16108,3986,8402,2572,3194,1631,3552,1437,2955,1192,597,548,252,406,345,395,523,520,1133,821,7706,2302,2358,1354,2993,1181,2640,1084,353,431,178,303,175,338,1390,880,965,818
45051,281915,50131,134762,30358,42484,20490,72049,17571,65820,15976,6229,6704,3074,4447,3155,4611,4232,4732,15997,10977,147153,30414,37671,18460,73482,17653,65998,15995,7484,7519,4255,5351,3229,4673,16137,9703,19863,11833
45053,23501,6080,11748,3611,4216,2554,5771,2037,5136,1811,635,835,246,425,389,642,445,567,1316,1097,11753,3447,3130,2159,5889,2162,5195,1900,694,841,297,493,397,597,1005,813,1729,1404
45055,52493,12019,24930,7217,7693,4402,13765,4482,12598,4097,1167,1506,453,917,714,1183,716,1058,2756,2322,27563,7046,7641,4363,13491,4405,12025,3938,1466,1713,800,1215,666,1119,3040,2169,3391,2511
45057,75341,15691,36065,9716,11643,6694,19759,4992,18196,4496,1563,1786,739,1294,824,1242,1714,1912,2949,2618,39276,9137,9770,5562,20416,5288,18558,4775,1858,2101,861,1400,997,1490,4595,2830,4495,3324
45059,54631,13449,26126,8111,8979,5432,13409,4720,12241,4451,1168,1619,813,1387,355,976,921,1230,2817,2401,28505,7894,8125,4647,13843,4695,12213,4379,1630,1909,1073,1541,557,1129,3375,2477,3162,2723
45061,14596,3566,7466,2058,3718,1538,2966,1141,2598,1081,368,380,244,355,124,262,233,340,549,439,7130,2133,2326,1352,3034,1174,2577,1046,457,483,300,382,157,307,1048,680,722,673
45063,234472,38840,112960,24014,35306,16927,63507,14336,58228,13311,5279,5495,2666,3981,2613,3872,2981,3850,11166,8164,121512,23620,32910,15836,62595,13975,56907,12979,5688,5600,3555,4467,2133,3423,11105,7159,14902,8975
45065,8636,1719,4734,1042,1549,687,2242,598,1878,572,364,208,151,160,213,185,245,225,698,391,3902,962,881,555,2181,663,1827,539,354,337,216,267,138,203,448,293,392,298
45067,25296,8072,11319,4576,4811,3136,4961,2505,4189,2172,772,1012,413,714,359,670,547,869,1000,1103,13977,5061,5467,3505,5231,2620,4559,2310,672,958,493,808,179,553,1930,1535,1349,1329
45069,22277,5703,11666,3519,5545,2375,4537,1892,3579,1608,958,787,498,581,460,541,336,517,1248,943,10611,3182,3825,2061,4101,1738,3504,1566,597,629,386,525,211,423,1604,1186,1081,944
45071,31355,8505,15082,5247,5060,3396,8093,3054,7073,2767,1020,1211,539,884,481,784,478,743,1451,1417,16273,4899,5004,2987,8133,2941,7171,2752,962,1047,721,929,241,535,1673,1375,1463,1347
45073,64680,14129,31589,8373,9052,5077,17989,5260,16649,4973,1340,1652,683,1310,657,1080,1138,1431,3410,2853,33091,8177,7399,4522,18022,5316,16720,4965,1302,1653,787,1297,515,1075,3595,2675,4075,2999
45075,71579,21452,32754,12613,13930,8913,14612,6267,12295,5411,2317,2849,1579,2307,738,1482,1468,1950,2744,2887,38825,12757,14946,8496,15127,6289,12864,5750,2263,2430,1564,1993,699,1417,5441,4157,3311,3072
45077,104585,20588,51745,13291,20221,9721,25386,6962,23408,6555,1978,2251,1118,1697,860,1455,1618,2005,4520,3673,52840,11977,16790,7862,25721,7011,23278,6493,2443,2745,1798,2408,645,1319,4711,3270,5618,3936
45079,338112,71935,162130,45198,75623,34941,69022,22623,60829,20349,8193,8461,3315,5684,4878,6258,3457,5599,14028,12010,175982,44087,71401,31738,69688,22604,59180,19617,10508,10549,6514,8124,3994,6157,13598,10730,21295,14383
45081,16588,3819,8177,2175,2979,1497,4153,1442,3648,1255,505,617,201,361,304,471,185,287,860,710,8411,2253,2378,1343,4338,1410,3731,1259,607,659,390,499,217,392,961,696,734,709
45083,248451,52148,119296,31249,40177,20775,63384,18596,57582,17224,5802,6681,3062,4892,2740,4536,3932,5243,11803,9484,129155,30756,36066,18720,64985,18916,57899,17318,7086,7438,4501,5840,2585,4440,12369,9161,15735,10823
45085,85327,20133,40407,11857,15474,8299,20135,6980,17905,6386,2230,2503,1320,1936,910,1519,1153,1613,3645,3297,44920,11859,13803,7285,21593,7123,18256,6373,3337,3109,2251,2551,1086,1644,5277,3694,4247,3439
45087,22669,5384,10622,3155,3408,1906,5474,1968,4957,1860,517,635,312,534,205,431,483,611,1257,1114,12047,3157,3205,1778,5684,2088,4959,1875,725,811,502,676,223,470,1436,1025,1722,1238
45089,25944,7044,12275,3966,4796,2618,5768,2459,4847,2215,921,860,531,754,390,542,577,791,1134,975,13669,4305,4495,2663,5908,2609,5303,2479,605,722,426,607,179,483,2140,1396,1126,1117
45091,212248,33888,100908,20282,31786,14455,57431,12442,53582,11898,3849,4080,2111,2956,1738,2740,2520,3277,9171,6498,111340,20755,31503,13628,58013,13018,53260,11925,4753,4801,2759,3525,1994,3084,9261,6119,12563,7717
46003,2184,320,1164,224,393,178,637,140,600,138,37,37,4,34,33,35,19,27,115,67,1020,161,182,87,642,136,626,131,16,49,0,40,16,49,131,68,65,47
46005,14095,3269,7219,2020,2307,1331,3862,1336,3595,1299,267,350,111,252,156,268,233,318,817,615,6876,1891,1621,1041,3741,1281,3565,1264,176,306,41,193,135,285,786,640,728,654
46007,2368,420,1117,252,498,212,484,140,442,133,42,57,2,33,40,64,44,49,91,79,1251,268,569,213,499,147,436,138,63,63,20,37,43,55,98,67,85,60
46009,5827,608,3502,402,1406,297,1388,272,1151,233,237,92,106,83,131,63,122,96,586,169,2325,343,387,167,1388,272,1313,265,75,75,41,60,34,54,354,145,196,100
46011,28608,4872,14741,3317,7412,2783,6193,1563,5916,1495,277,387,35,216,242,373,268,354,868,736,13867,3075,6075,2427,6028,1513,5696,1454,332,447,107,283,225,375,821,671,943,757
46013,31313,6503,15330,3857,5227,2782,7992,2307,7724,2256,268,478,45,341,223,441,410,562,1701,1363,15983,4069,4416,2668,8384,2519,7912,2322,472,730,143,433,329,619,1575,1139,1608,1223
46015,4156,827,1995,449,624,321,1122,288,1088,283,34,59,2,45,32,66,53,69,196,162,2161,545,462,335,1262,337,1216,337,46,80,25,68,21,67,242,164,195,126
46017,1411,168,688,101,379,90,209,55,173,48,36,26,8,18,28,23,33,30,67,37,723,108,388,92,218,62,160,50,58,36,23,24,35,25,40,28,77,34
46019,8134,1879,4103,1099,1234,728,2187,767,2044,743,143,214,93,172,50,122,136,200,546,439,4031,1115,704,505,2121,776,1947,741,174,232,118,185,56,117,457,367,749,534
46021,1242,183,653,106,122,53,423,81,419,81,4,15,0,20,4,15,23,24,85,42,589,103,92,46,416,83,411,82,5,15,3,14,2,13,55,33,26,18
46023,7002,836,3474,486,1252,329,1680,321,1530,290,150,122,64,88,86,87,172,147,370,197,3528,537,1038,348,1733,338,1568,298,165,149,59,83,106,121,459,210,298,135
46025,2832,500,1408,284,376,158,822,225,797,224,25,50,2,54,23,49,50,62,160,111,1424,284,229,122,852,223,826,223,26,45,7,50,19,55,220,115,123,99
46027,11955,2290,5753,1566,2988,1289,2235,693,2133,677,102,197,2,114,100,203,67,145,463,394,6202,1481,3049,1159,2409,746,2201,705,208,257,47,162,161,231,355,320,389,340
46029,22423,4284,11254,2818,3434,1957,6380,1769,6117,1733,263,410,115,313,148,333,371,469,1069,990,11169,2396,2775,1541,6123,1732,5820,1668,303,424,103,279,200,340,1134,873,1137,820
46031,2861,262,1443,175,681,134,573,102,514,97,59,39,34,29,25,28,59,39,130,55,1418,149,578,100,550,100,471,96,79,38,54,31,25,36,125,50,165,51
46033,7594,1223,3690,707,669,380,2586,545,2508,535,78,104,7,51,71,103,66,93,369,237,3904,722,634,529,2530,582,2417,559,113,153,20,68,93,140,379,255,361,223
46035,16332,3855,8101,2299,2455,1409,4504,1592,4168,1532,336,447,188,364,148,278,178,296,964,936,8231,2389,1961,1293,4725,1629,4386,1539,339,503,224,413,115,262,878,734,667,674
46037,4512,568,2302,361,571,251,1350,276,1290,268,60,63,18,47,42,56,73,72,308,168,2210,359,401,201,1286,253,1246,250,40,47,14,51,26,35,307,158,216,131
46039,3459,476,1773,286,422,156,1153,244,1102,235,51,57,0,40,51,57,39,40,159,96,1686,253,253,126,1172,222,1134,220,38,44,5,27,33,42,188,90,73,52
46041,3972,425,1912,263,842,202,748,161,700,159,48,48,21,42,27,39,82,62,240,93,2060,274,827,197,765,163,700,158,65,55,46,52,19,47,159,79,309,123
46043,2341,326,1165,200,248,125,823,139,798,138,25,36,7,21,18,33,40,46,54,42,1176,189,98,68,878,169,863,170,15,18,6,28,9,14,143,82,57,40
46045,3093,441,1609,269,442,167,1022,213,976,207,46,66,1,32,45,66,46,52,99,85,1484,270,245,129,960,205,931,198,29,51,12,48,17,42,178,103,101,71
46047,5827,1225,2865,734,810,430,1408,501,1269,461,139,150,15,65,124,146,208,158,439,332,2962,709,563,342,1603,542,1521,529,82,119,48,98,34,81,365,265,431,313
46049,1867,339,907,279,268,216,544,158,494,121,50,80,8,11,42,85,12,31,83,49,960,276,283,229,473,112,455,114,18,23,5,17,13,22,132,78,72,42
46051,5863,1432,3054,897,888,682,1910,638,1859,632,51,112,12,81,39,113,73,104,183,189,2809,789,471,357,1820,608,1758,618,62,140,1,82,61,148,229,215,289,273
46053,3361,365,1703,236,478,155,943,169,901,165,42,45,18,32,24,33,83,56,199,92,1658,198,299,110,977,161,926,162,51,47,26,36,25,31,218,78,164,102
46055,1586,255,799,156,169,103,571,114,551,114,20,23,1,13,19,23,20,21,39,38,787,128,91,57,557,105,534,103,23,31,11,26,12,22,108,50,31,30
46057,4434,520,2253,314,537,187,1469,263,1419,260,50,52,6,50,44,50,84,72,163,97,2181,299,381,149,1509,254,1416,232,93,104,40,61,53,83,145,82,146,91
46059,2655,365,1347,207,287,133,903,166,884,166,19,26,0,40,19,26,65,65,92,62,1308,231,235,116,811,164,797,162,14,34,0,40,14,34,173,98,89,57
46061,2519,337,1265,224,441,163,715,119,657,107,58,52,11,32,47,50,23,21,86,59,1254,185,320,141,708,118,689,117,19,28,11,38,8,20,96,43,130,75
46063,1089,87,577,63,143,67,391,48,363,49,28,19,15,17,13,9,5,5,38,21,512,55,73,32,373,52,356,46,17,33,1,2,16,32,29,12,37,23
46065,14119,2955,6833,1843,2077,1242,3705,1223,3553,1204,152,253,64,195,88,206,265,329,786,635,7286,1803,1970,1146,3595,1174,3299,1130,296,309,82,202,214,282,580,501,1141,780
46067,5747,819,2785,500,770,382,1646,325,1585,312,61,93,18,65,43,82,78,104,291,180,2962,483,553,266,1777,344,1712,328,65,90,9,54,56,98,410,166,222,134
46069,1111,164,563,113,163,87,364,75,355,72,9,19,3,14,6,19,9,17,27,21,548,83,75,45,340,68,327,66,13,18,2,13,11,17,82,42,51,30
46071,2403,447,1220,240,523,165,498,163,426,149,72,66,17,45,55,59,54,59,145,109,1183,283,496,188,430,148,368,135,62,70,5,37,57,68,128,92,129,91
46073,1649,194,797,109,162,72,565,103,548,102,17,25,2,13,15,25,8,12,62,40,852,122,127,56,551,107,533,105,18,22,7,22,11,17,126,63,48,39
46075,674,85,354,52,111,39,208,40,208,40,0,10,0,10,0,10,22,20,13,14,320,45,50,26,209,45,198,44,11,11,11,11,0,10,38,20,23,20
46077,4014,562,2058,351,450,195,1295,243,1204,235,91,87,25,43,66,76,60,54,253,155,1956,292,292,140,1258,242,1226,235,32,59,19,58,13,48,258,119,148,99
46079,10514,2046,5549,1219,1790,779,3159,847,2932,823,227,245,67,147,160,212,129,170,471,358,4965,1158,1149,569,2760,780,2671,767,89,142,59,141,30,86,429,313,627,511
46081,21765,4064,10811,2571,3637,1939,5480,1553,5228,1516,252,427,83,245,169,346,322,455,1372,941,10954,2391,2972,1537,5405,1536,5213,1499,192,308,28,182,164,287,1226,847,1351,917
46083,43098,7304,21060,4505,6656,3538,12427,2767,12018,2637,409,666,92,366,317,606,369,587,1608,1386,22038,4479,5292,2928,13060,2857,12388,2700,672,865,337,603,335,582,1607,1443,2079,1450
46085,2894,327,1504,196,602,140,732,158,699,155,33,35,12,34,21,28,20,30,150,74,1390,191,425,113,704,173,648,150,56,65,14,35,42,67,132,74,129,68
46087,4284,604,2114,375,570,311,1307,241,1254,234,53,67,11,47,42,68,51,50,186,93,2170,380,457,273,1383,272,1291,243,92,130,19,54,73,115,174,108,156,103
46089,1863,315,906,169,236,99,548,125,511,122,37,44,0,30,37,44,35,36,87,63,957,185,145,75,545,136,503,128,42,42,18,44,24,28,175,91,92,59
46091,3799,489,2000,300,609,193,1109,230,1066,230,43,50,12,24,31,46,69,68,213,106,1799,250,303,128,1116,212,1049,211,67,48,9,23,58,41,231,131,149,83
46093,22219,3734,11570,2426,3663,1749,6569,1626,6221,1558,348,439,94,242,254,379,311,415,1027,840,10649,2157,2343,1283,6355,1565,6160,1554,195,297,28,172,167,284,1007,918,944,663
46095,1459,235,756,133,287,86,373,88,331,88,42,28,17,19,25,19,25,23,71,38,703,127,211,80,335,82,296,73,39,29,24,25,15,17,89,40,68,36
46097,1758,247,895,149,235,108,536,110,523,111,13,26,3,25,10,24,25,22,99,49,863,145,156,78,527,106,496,108,31,41,9,21,22,40,113,53,67,43
46099,148078,24924,74343,16090,25542,11242,39315,9962,37250,9495,2065,2783,898,1987,1167,2095,1753,2421,7733,5790,73735,14932,21138,10403,37953,9523,35611,9083,2342,2846,1069,2075,1273,2142,5594,4301,9050,5833
46101,5113,877,2568,549,728,305,1561,411,1443,330,118,201,29,72,89,173,77,78,202,114,2545,453,505,242,1538,401,1454,334,84,170,8,54,76,169,206,127,296,145
46102,9818,2888,4727,1612,3043,1290,990,589,752,503,238,246,115,163,123,182,105,169,589,480,5091,1705,3013,1322,999,604,738,483,261,290,67,150,194,229,392,317,687,510
46103,89075,16125,44669,10167,15610,7336,22670,5746,21604,5520,1066,1528,477,1108,589,1127,1043,1535,5346,3894,44406,9779,12038,6620,22264,5794,20839,5478,1425,1802,568,1160,857,1361,3953,2912,6151,3895
46105,2380,324,1245,188,318,130,822,148,794,150,28,38,3,23,25,37,34,24,71,40,1135,177,141,91,740,135,731,134,9,21,5,27,4,24,158,83,96,46
46107,1888,205,936,110,214,73,602,94,583,93,19,21,3,14,16,19,32,32,88,47,952,137,184,96,545,87,527,88,18,24,4,15,14,21,121,51,102,60
46109,7929,1225,4045,797,1387,534,1983,495,1829,470,154,168,48,148,106,150,198,174,477,268,3884,712,1104,461,1852,447,1723,424,129,143,62,118,67,113,441,239,487,275
46111,1885,239,960,147,231,97,622,125,612,125,10,18,0,30,10,18,13,22,94,60,925,146,166,88,561,102,552,101,9,22,7,21,2,23,90,59,108,55
46115,5260,760,2612,454,787,303,1478,320,1401,306,77,90,19,60,58,85,85,77,262,141,2648,432,607,242,1400,291,1321,288,79,82,46,78,33,62,336,165,305,174
46117,2414,301,1248,171,254,91,855,145,845,144,10,24,0,20,10,24,45,53,94,65,1166,163,219,84,808,134,807,134,1,13,0,20,1,13,62,47,77,49
46119,1054,161,529,83,119,50,341,66,327,65,14,16,0,20,14,16,14,13,55,32,525,111,114,79,304,56,298,56,6,17,0,20,6,17,56,38,51,28
46121,6538,1136,3136,714,1838,604,873,327,702,278,171,177,50,85,121,147,119,124,306,195,3402,672,1967,522,821,313,661,266,160,149,61,101,99,114,252,166,362,227
46123,4410,710,2214,424,674,289,1332,335,1303,339,29,57,6,52,23,48,51,61,157,120,2196,419,464,288,1304,327,1262,321,42,63,16,52,26,61,250,166,178,134
46125,6639,864,3288,499,774,304,2154,374,2059,354,95,112,30,75,65,97,101,97,259,134,3351,498,567,247,2132,358,2041,348,91,103,30,64,61,87,403,183,249,129
46127,12333,1536,6138,963,1560,662,3765,719,3637,712,128,162,70,123,58,117,185,197,628,370,6195,863,1313,572,3656,698,3537,687,119,165,88,142,31,110,469,264,757,383
46129,4391,1039,2193,563,693,328,1207,416,1118,372,89,128,20,81,69,125,59,90,234,187,2198,623,409,306,1171,391,1133,382,38,91,20,76,18,81,354,244,264,205
46135,18720,3583,9902,2230,3292,1494,5102,1449,4730,1396,372,353,103,264,269,288,382,410,1126,827,8818,2223,2303,1525,4855,1350,4657,1326,198,312,49,218,149,295,832,677,828,661
46137,2110,160,1076,101,606,91,325,68,287,57,38,30,13,15,25,26,37,32,108,41,1034,91,408,68,363,57,338,53,25,23,23,23,2,14,88,34,175,55
47001,62867,13711,30365,7983,8646,4864,16718,5145,15247,4746,1471,1693,844,1318,627,1106,1091,1389,3910,2869,32502,8304,6865,4576,16824,5106,15438,4854,1386,1688,901,1342,485,1007,3939,2812,4874,3310
47003,38077,8019,18686,4807,6060,3264,10134,2894,9181,2689,953,1101,425,645,528,774,562,710,1930,1504,19391,4440,4593,2651,10273,2938,9237,2723,1036,1133,619,779,417,709,1988,1384,2537,1933
47005,13581,2874,6527,1679,1646,924,3333,1063,2881,943,452,471,242,351,210,286,279,316,1269,782,7054,1851,1435,963,3121,1043,2800,959,321,382,166,274,155,258,1252,695,1246,738
47007,12476,2415,7297,1600,2165,903,3820,1043,3284,947,536,336,222,264,314,199,275,271,1037,608,5179,1158,976,592,2824,773,2619,772,205,273,128,199,77,175,590,422,789,492
47009,108480,21203,52126,12559,14593,7978,29598,7655,27708,7290,1890,2507,792,1601,1098,1954,1690,2085,6245,4596,56354,12632,11909,6920,30943,8152,28066,7399,2877,3158,1207,1999,1670,2252,5584,3957,7918,5297
47011,86688,17449,41772,10192,12352,6624,23073,6314,21181,5925,1892,2114,797,1339,1095,1535,1264,1646,5083,3661,44916,10317,10208,5440,23645,6519,21503,6027,2142,2198,1196,1528,946,1447,4433,3238,6630,4314
47013,33063,7910,15969,4460,4273,2640,8998,3025,8217,2786,781,1001,498,848,283,582,772,910,1926,1448,17094,4498,3394,2228,8629,2912,7954,2736,675,934,525,814,150,474,2543,1565,2528,1764
47015,11671,2246,5763,1364,1497,829,3383,947,3131,867,252,301,123,204,129,227,231,287,652,481,5908,1292,1097,619,3356,923,2958,806,398,437,243,317,155,264,637,460,818,500
47017,22923,4843,11050,2879,3214,1742,6121,1778,5736,1724,385,458,115,288,270,429,264,352,1451,1050,11873,2787,2761,1581,6423,1850,5859,1750,564,661,242,453,322,497,1425,853,1264,859
47019,47801,8909,23205,5343,6427,3337,12476,3441,11735,3316,741,894,390,731,351,623,1020,1176,3282,2272,24596,5267,4966,2859,12603,3571,11474,3279,1129,1267,688,1006,441,792,3027,1986,4000,2411
47021,32960,5206,16306,3188,4942,2113,8781,1948,8372,1897,409,551,109,317,300,479,564,624,2019,1312,16654,3056,3834,1956,9282,1999,8611,1912,671,712,347,512,324,504,1525,974,2013,1226
47023,14023,2728,6645,1575,1989,950,3879,1159,3672,1109,207,273,150,257,57,136,251,266,526,462,7378,1709,1988,1053,3832,1119,3556,1066,276,324,165,238,111,223,906,589,652,519
47025,26784,5237,12915,2976,3480,1650,7102,2090,6628,2005,474,557,186,373,288,457,600,635,1733,1180,13869,3112,3029,1598,7473,2162,6735,2052,738,791,454,582,284,485,1461,992,1906,1213
47027,6384,1600,3055,894,669,450,1718,552,1506,509,212,233,99,157,113,170,103,143,565,423,3329,958,546,381,1800,622,1657,585,143,180,45,108,98,148,386,296,597,435
47029,29500,7731,14173,4238,3969,2509,7238,2789,6418,2507,820,1034,555,825,265,540,818,931,2148,1587,15327,4761,3315,2555,7288,2722,6522,2569,766,904,384,633,382,640,1999,1561,2725,2001
47031,44265,9087,21397,5255,5795,3253,11947,3493,11040,3192,907,1153,407,763,500,801,929,1054,2726,1973,22868,5422,4459,2887,13013,3774,11735,3391,1278,1506,797,1157,481,868,2557,1813,2839,2001
47033,11509,1996,5462,1123,1545,667,2992,779,2660,713,332,343,141,211,191,252,212,227,713,452,6047,1189,1223,599,3155,797,2808,745,347,341,160,204,187,261,687,404,982,522
47035,50419,8737,24439,5176,5282,2895,15409,3542,14211,3337,1198,1289,691,984,507,747,929,1050,2819,1956,25980,5094,3867,2360,14982,3420,13916,3304,1066,1150,743,966,323,588,3602,2241,3529,2296
47037,563205,121777,268301,76767,113174,57143,120691,42155,108217,38297,12474,15404,4590,9772,7884,11934,5705,10039,28731,23544,294904,75116,113316,53572,122294,42367,109672,38797,12622,15507,5920,10580,6702,11325,21001,18025,38293,26684
47039,9613,1984,4634,1152,1107,665,2688,757,2488,713,200,242,88,160,112,206,174,197,665,504,4979,1137,968,609,2715,755,2539,739,176,207,53,111,123,189,548,313,748,455
47041,16338,3469,8043,2169,2109,1319,4894,1423,4543,1364,351,432,149,261,202,304,147,234,893,677,8295,1899,1534,865,4775,1371,4228,1288,547,578,252,360,295,411,1089,754,897,700
47043,42542,8990,20639,5202,6643,3507,11120,3168,10380,2979,740,932,343,664,397,655,673,768,2203,1609,21903,5299,5245,3042,11448,3255,10495,3059,953,1108,339,630,614,891,2112,1459,3098,2036
47045,30120,7182,14315,4094,3578,2171,8245,2857,7531,2703,714,894,288,558,426,665,683,845,1809,1478,15805,4286,3538,2372,8014,2790,7231,2603,783,978,534,822,249,493,1805,1394,2448,1742
47047,33747,6580,16542,4064,4835,2806,9635,2361,9053,2282,582,733,323,541,259,520,403,548,1669,1306,17205,3695,4070,2240,9639,2330,9196,2214,443,661,106,399,337,624,1955,1329,1541,1172
47049,15084,3250,7483,1901,1845,1011,4423,1368,4157,1333,266,359,153,291,113,213,219,274,996,737,7601,1842,1343,817,4174,1289,3882,1215,292,397,111,245,181,285,900,635,1184,767
47051,34962,7268,16893,4177,5138,2723,9433,2580,8690,2401,743,826,306,543,437,598,451,589,1871,1315,18069,4246,4164,2159,9789,2815,9087,2596,702,829,344,596,358,592,1989,1181,2127,1506
47053,39477,9251,18627,5481,5728,3579,10161,3413,9230,3181,931,1094,388,748,543,855,608,853,2130,1883,20850,5502,4815,3117,10711,3508,9600,3280,1111,1267,731,1067,380,722,2680,1867,2644,2098
47055,24229,4345,11687,2595,3423,1733,6221,1687,5811,1589,410,539,274,436,136,333,451,480,1592,982,12542,2675,2700,1460,6548,1761,5932,1642,616,669,381,495,235,380,1557,929,1737,1006
47057,19329,4109,9621,2382,2350,1325,5868,1635,5354,1550,514,554,182,295,332,470,450,510,953,740,9708,2272,1574,1119,5605,1574,5325,1532,280,359,142,261,138,275,1199,829,1330,891
47059,58056,13238,28051,7619,7666,4511,15026,4808,13942,4522,1084,1530,491,1068,593,1055,1119,1350,4240,3156,30005,7907,6330,3959,15101,4788,13725,4451,1376,1649,808,1276,568,985,3437,2576,5137,3574
47061,10976,2373,5335,1319,1590,768,2745,845,2429,746,316,341,208,282,108,181,211,215,789,509,5641,1345,1299,666,2886,882,2543,761,343,386,170,209,173,282,759,495,697,451
47063,51780,13267,25156,7850,7682,4656,13486,4717,12708,4573,778,1093,476,885,302,749,1064,1460,2924,2671,26624,7847,5610,3981,13687,4763,12572,4562,1115,1394,543,986,572,1021,3323,2675,4004,3132
47065,297952,65197,142044,39607,49637,27400,72745,23718,67419,22148,5326,7090,2361,4883,2965,5298,4387,6190,15275,12994,155908,39524,45303,24511,73737,23737,67602,21964,6135,7861,2813,5355,3322,5701,16028,12617,20840,14824
47067,5454,973,2729,572,772,313,1396,388,1260,365,136,141,70,92,66,99,149,138,412,233,2725,540,617,327,1360,391,1314,392,46,76,37,71,9,49,386,205,362,198
47069,21485,4164,12076,2732,5188,2119,4817,1538,3886,1355,931,494,333,371,598,363,414,381,1657,854,9409,2326,2820,1503,4435,1489,3947,1387,488,560,200,350,288,409,983,712,1171,764
47071,21460,4803,10389,2809,2562,1573,5816,1805,5452,1741,364,477,130,315,234,382,391,482,1620,1129,11071,2707,2035,1226,6135,1808,5546,1711,589,635,263,420,326,477,1470,1038,1431,1068
47073,47330,8857,22931,5416,6333,3399,12239,3366,11458,3204,781,1029,287,627,494,854,1062,1152,3297,2293,24399,5106,4572,2669,12921,3520,11573,3271,1348,1454,593,850,755,1083,3084,2029,3822,2409
47075,14334,3169,6565,1893,2149,1220,3213,1156,2878,1076,335,425,108,223,227,354,268,340,935,756,7769,1956,2472,1332,3312,1168,2879,1102,433,449,276,348,157,289,979,612,1006,673
47077,22744,5494,10870,3093,3003,1748,5915,1879,5521,1786,394,510,174,362,220,385,413,538,1539,1239,11874,3347,2507,1770,6163,2000,5605,1823,558,665,312,501,246,421,1360,1070,1844,1357
47079,26765,6004,12848,3558,3396,1998,7215,2442,6762,2359,453,612,237,458,216,457,607,733,1630,1349,13917,3463,2471,1685,7408,2484,6849,2360,559,757,232,502,327,579,1947,1317,2091,1568
47081,20617,4365,10852,2690,3792,1654,5100,1613,4562,1528,538,515,173,305,365,401,474,487,1486,909,9765,2379,2408,1433,5037,1588,4530,1539,507,509,207,349,300,393,1086,763,1234,854
47083,6718,1457,3417,874,1238,571,1652,470,1503,445,149,169,82,145,67,96,136,166,391,251,3301,811,670,483,1733,494,1622,487,111,131,54,112,57,102,410,264,488,276
47085,15215,3539,7287,1962,2101,1331,4076,1256,3896,1230,180,310,115,274,65,224,190,255,920,794,7928,2254,1649,1161,4428,1478,3917,1305,511,581,253,407,258,353,890,662,961,785
47087,9985,1851,4993,1154,1397,758,2592,729,2244,639,348,347,81,143,267,308,221,225,783,464,4992,1064,1135,595,2147,579,1983,562,164,168,121,134,43,117,745,447,965,508
47089,45032,9666,21933,5589,6015,3190,12434,3520,11423,3294,1011,1191,566,860,445,773,915,1043,2569,2064,23099,5560,4694,2841,12951,3757,11720,3403,1231,1439,505,783,726,1083,2242,1653,3212,2143
47091,15289,2989,8297,1784,2765,1202,4100,1265,3521,1206,579,368,178,237,401,297,234,266,1198,581,6992,1679,1232,854,3865,1221,3688,1204,177,252,106,199,71,191,955,631,940,667
47093,380232,65294,182838,40350,63643,29480,95028,23418,89093,22040,5935,7313,2436,4810,3499,5578,5087,6306,19080,13468,197394,40487,56764,27465,97426,23907,90230,22334,7196,8090,4018,5812,3178,5445,16740,11287,26464,15479
47095,6559,979,4224,686,2106,475,1325,425,757,335,568,211,232,165,336,151,98,114,695,282,2335,515,512,259,1092,397,995,392,97,121,72,101,25,80,425,238,306,235
47097,21107,4028,10867,2510,4067,1698,5059,1611,4342,1513,717,501,182,372,535,417,355,395,1386,827,10240,2429,2881,1458,4772,1549,4259,1424,513,517,349,457,164,350,1115,784,1472,917
47099,34356,6741,16634,3980,4455,2443,9374,2496,8836,2408,538,703,275,533,263,544,599,731,2206,1448,17722,3960,3654,2049,9241,2481,8631,2386,610,748,402,624,208,476,2085,1344,2742,1722
47101,9884,2442,4742,1391,1357,804,2594,881,2537,856,57,115,10,88,47,111,210,228,581,441,5142,1436,1216,724,2687,897,2436,835,251,320,128,206,123,195,526,445,713,526
47103,27669,6134,13474,3753,3756,2221,7653,2287,6995,2106,658,800,358,575,300,531,369,515,1696,1271,14195,3334,2578,1579,7593,2236,7147,2159,446,611,205,458,241,463,1922,1300,2102,1383
47105,43830,9402,21302,5525,5077,3290,12933,3511,12264,3398,669,901,284,600,385,684,1021,1125,2271,1842,22528,5412,3810,2493,13292,3616,12492,3430,800,1014,321,635,479,782,2541,1777,2885,2035
47107,43866,9589,21217,5493,6056,3223,11577,3569,10729,3398,848,1104,427,779,421,788,958,1092,2626,2024,22649,5786,4511,2833,11825,3774,10667,3488,1158,1342,700,967,458,804,2823,1849,3490,2375
47109,21220,4537,10234,2471,2754,1451,5403,1503,4916,1387,487,525,244,339,243,379,398,460,1679,1098,10986,2813,2246,1313,5818,1613,5384,1531,434,539,251,414,183,291,1408,873,1514,1028
47111,18932,4070,9228,2304,2465,1382,5610,1602,5157,1525,453,488,159,291,294,392,180,303,973,756,9704,2373,1869,1249,5833,1740,5432,1641,401,465,283,368,118,251,1102,743,900,654
47113,79440,18362,36946,10677,13009,7413,19186,6359,17080,5519,2106,2543,1105,1740,1001,1689,1075,1535,3676,3047,42494,11368,13286,7451,19658,6373,17531,5650,2127,2533,1022,1691,1105,1827,3908,3094,5642,3921
47115,23572,4750,11350,2760,2858,1604,6614,1863,6247,1803,367,458,137,297,230,398,437,494,1441,957,12222,2717,2453,1353,6844,1974,6304,1821,540,613,306,436,234,407,1388,948,1537,1006
47117,26663,5194,12913,2952,3372,1743,7617,2023,6827,1886,790,859,511,681,279,424,522,611,1402,1020,13750,3247,3112,1882,7100,1902,6480,1813,620,634,318,434,302,449,1358,961,2180,1331
47119,73903,14420,35233,8410,10044,5481,20030,5188,18604,4860,1426,1705,581,1084,845,1277,1176,1480,3983,3058,38670,8508,9561,5264,20070,5176,18571,4876,1499,1729,782,1277,717,1136,3512,2479,5527,3390
47121,10101,1431,5022,808,1028,440,2899,596,2771,581,128,158,70,109,58,104,152,143,943,439,5079,799,740,370,3044,635,2826,612,218,191,123,136,95,116,586,305,709,363
47123,37987,8925,18564,5302,4512,3067,11180,3569,10292,3261,888,1147,361,709,527,822,668,853,2204,1714,19423,4907,3699,2416,10709,3362,9993,3144,716,897,452,713,264,540,2058,1661,2957,2110
47125,154096,27710,76330,16937,23750,11324,43294,10949,39784,10412,3510,3716,1296,2096,2214,2903,1586,2212,7700,5611,77766,16359,19785,10265,42242,10425,37516,9643,4726,4250,1591,2341,3135,3266,5243,4173,10496,6264
47127,5346,863,2656,497,659,295,1664,384,1579,395,85,96,20,36,65,83,104,100,229,158,2690,482,496,267,1790,415,1685,402,105,109,59,87,46,73,265,181,139,120
47129,18161,3757,10060,2174,3536,1258,4830,1446,4195,1281,635,418,139,230,496,363,298,368,1396,772,8101,1990,1471,897,4818,1357,4462,1323,356,406,205,328,151,262,891,646,921,690
47131,24949,5079,11872,2943,3250,1763,6706,1939,6225,1838,481,602,331,523,150,378,378,490,1538,1176,13077,3168,3095,1866,6477,1875,6075,1816,402,511,242,421,160,345,1670,1034,1835,1182
47133,18093,3273,8748,1963,2079,1118,5320,1365,5005,1346,315,369,142,262,173,276,271,316,1078,721,9345,1814,1470,776,5471,1440,5182,1385,289,364,166,288,123,235,998,619,1406,857
47135,6556,1690,3215,940,1048,559,1724,606,1669,601,55,110,5,80,50,107,142,179,301,263,3341,942,690,433,1852,616,1753,605,99,147,45,112,54,121,468,312,331,245
47137,4335,1060,2186,656,430,278,1450,520,1392,502,58,96,16,70,42,87,95,144,211,180,2149,552,220,187,1308,475,1248,464,60,96,44,87,16,65,373,269,248,202
47139,14135,2661,7061,1551,1764,883,4298,1144,4040,1089,258,317,159,251,99,183,136,182,863,557,7074,1435,942,583,4446,1138,4182,1119,264,257,138,208,126,187,773,487,913,631
47141,64124,11759,31617,7525,12226,5506,15188,4393,14127,4099,1061,1261,534,962,527,853,699,913,3504,2563,32507,6878,8978,4401,15501,4396,14510,4202,991,1219,603,1024,388,768,3322,2363,4706,2970
47143,26402,6011,13068,3604,3674,1971,6920,2222,6436,2142,484,590,151,340,333,516,502,557,1972,1394,13334,3495,2663,1696,7027,2300,6383,2131,644,722,386,545,258,429,1621,1194,2023,1461
47145,45083,11927,21898,6646,5871,3943,12296,4339,11674,4162,622,964,149,591,473,862,943,1233,2788,2452,23185,7084,4762,3844,12356,4345,11262,4044,1094,1513,558,1036,536,971,2544,2078,3523,2759
47147,56323,9335,27587,5731,7210,3390,16931,3855,15965,3630,966,1128,369,688,597,855,717,834,2729,1885,28736,5321,6186,3037,16338,3637,15535,3540,803,951,452,691,351,654,2401,1625,3811,2210
47149,250891,42679,122391,26256,44079,19297,64859,15685,60188,14543,4671,5245,1562,2809,3109,4289,2584,3585,10869,7898,128500,25885,39940,18171,64278,15541,59519,14469,4759,5342,1932,3260,2827,4070,8538,6637,15744,9550
47151,17623,4661,8630,2662,2137,1353,4863,1894,4605,1824,258,368,170,312,88,237,257,340,1373,955,8993,2566,1910,1338,4770,1780,4239,1673,531,590,288,402,243,389,1054,775,1259,904
47153,12454,2210,6208,1342,1321,801,3905,966,3534,876,371,374,159,235,212,272,117,150,865,534,6246,1283,982,624,3864,943,3532,862,332,338,238,312,94,153,583,437,817,498
47155,80737,16540,39096,9637,10524,5655,22861,6255,21154,5841,1707,1913,592,1111,1115,1518,1026,1280,4685,3309,41641,9542,8665,4999,22549,5953,20922,5753,1627,1757,856,1253,771,1119,4567,3022,5860,3857
47157,739920,181348,345267,107329,151828,81163,154210,54979,136081,48680,18129,22364,9468,15607,8661,15241,8219,13755,31010,28305,394653,112090,156310,81552,157384,55264,135643,48172,21741,24054,13430,18631,8311,14446,31989,26530,48970,35613
47159,16012,2549,7829,1519,2071,972,4470,1004,4222,966,248,264,131,222,117,183,187,206,1101,708,8183,1472,1650,800,4502,994,4092,949,410,362,240,294,170,230,874,495,1157,639
47161,11076,2337,5392,1355,1423,847,3036,941,2857,917,179,252,93,182,86,186,259,328,674,500,5684,1348,998,681,3137,971,2757,909,380,438,215,322,165,246,684,454,865,542
47163,132157,25482,63604,15118,16819,9299,35275,9947,32657,9400,2618,3211,1547,2606,1071,2011,2338,2810,9172,6317,68553,15175,13520,8128,35943,10154,33607,9728,2336,3108,1259,2346,1077,2131,8225,5465,10865,6859
47165,147583,25572,71310,15378,20155,10077,41354,9505,39320,8996,2034,2663,816,1759,1218,2081,1851,2415,7950,5661,76273,15111,17433,9063,41372,9579,38644,8855,2728,3300,1204,2129,1524,2402,6777,4785,10691,6464
47167,49081,10051,23882,5976,7598,3739,12920,3667,11990,3445,930,1100,369,703,561,836,776,921,2588,1992,25199,5831,6377,3512,13099,3611,12036,3378,1063,1223,612,884,451,739,2543,1738,3180,2227
47169,8602,1947,5055,1345,2023,986,2374,864,1812,714,562,434,286,302,276,284,104,143,554,362,3547,1007,832,611,1741,640,1407,523,334,308,284,295,50,106,482,328,492,389
47171,15310,3294,7675,2028,2087,1270,4094,1350,3723,1279,371,441,141,280,230,360,293,358,1201,816,7635,1900,1473,948,3804,1288,3445,1236,359,437,179,307,180,307,1095,707,1263,918
47173,15999,3434,7837,1981,1875,1116,4510,1365,4133,1321,377,407,224,345,153,268,249,297,1203,837,8162,1865,1643,984,4219,1279,4000,1280,219,278,135,227,84,221,861,667,1439,920
47175,4872,894,2434,492,573,285,1355,335,1240,313,115,115,85,106,30,54,98,100,408,229,2438,499,418,232,1316,325,1269,315,47,64,30,61,17,49,332,178,372,214
47177,32786,7102,16187,4326,4468,2469,8653,2699,7785,2499,868,1004,282,553,586,821,746,833,2320,1625,16599,3952,3284,1894,8584,2608,8060,2535,524,707,317,560,207,438,1768,1300,2963,1831
47179,107297,22295,51913,13604,17138,9276,27518,8347,25682,7897,1836,2400,610,1445,1226,1908,1704,2344,5553,4560,55384,13452,14794,8332,27667,8368,25385,7758,2282,2757,1158,1944,1124,1872,5418,4218,7505,5240
47181,14214,2993,7808,1845,2664,1044,3401,1071,2918,1010,483,373,274,308,209,248,357,389,1386,824,6406,1670,1096,745,3457,1155,3188,1083,269,337,162,270,107,233,886,599,967,701
47183,28190,5205,13611,2989,4569,1990,7072,1838,6732,1788,340,479,169,396,171,369,550,591,1420,1101,14579,3270,4265,2057,6905,1788,6534,1740,371,514,184,400,187,379,1803,1189,1606,1068
47185,21824,4567,10499,2601,2593,1577,6116,1684,5732,1608,384,489,158,345,226,367,347,426,1443,985,11325,2655,2057,1315,6187,1837,5534,1568,653,751,311,454,342,538,1497,965,1584,1042
47187,175417,24083,84856,13988,21225,9747,57909,9336,56518,9151,1391,2083,472,1402,919,1755,1316,1887,4406,3554,90561,14591,20396,9778,56587,9017,54778,8913,1809,2231,663,1484,1146,1820,4958,3935,8620,5068
47189,109827,19498,53389,11481,13429,7125,33405,7833,31442,7395,1963,2242,817,1435,1146,1718,1020,1447,5535,4029,56438,11290,11563,6336,33781,7713,31617,7304,2164,2475,1021,1611,1143,1756,4657,3355,6437,4242
48001,48518,11518,30500,7159,11469,4165,12958,4651,9049,3946,3909,1693,1146,1023,2763,1308,988,949,5085,2504,18018,5837,3918,3099,9652,3783,8790,3494,862,1222,368,881,494,898,1901,1672,2547,1943
48003,13273,3248,6719,1964,2013,1214,3946,1356,3649,1293,297,355,99,240,198,275,161,276,599,574,6554,1832,1409,908,3981,1337,3603,1302,378,421,273,386,105,207,346,405,818,728
48005,68706,16247,33240,9193,9858,5324,18151,5827,16167,5428,1984,1970,928,1425,1056,1347,1150,1508,4081,2953,35466,9560,9186,5337,17954,5695,16017,5264,1937,2110,1099,1572,838,1412,3640,2763,4686,3485
48007,20777,6373,10105,3489,2357,1806,5528,2189,4909,1981,619,687,100,377,519,594,406,558,1814,1435,10672,3701,1843,1601,6372,2670,5487,2144,885,1125,286,578,599,793,1026,941,1431,1151
48009,7214,1352,3600,792,932,457,2123,522,2003,508,120,172,46,143,74,137,146,172,399,272,3614,765,646,356,2142,521,1989,496,153,168,71,123,82,149,438,270,388,271
48011,1601,339,795,201,176,118,512,128,498,126,14,20,11,43,3,19,18,36,89,66,806,186,109,74,513,130,466,123,47,42,32,31,15,43,87,61,97,75
48013,38228,9971,18953,5786,6052,3384,10308,3666,9185,3396,1123,1331,521,830,602,986,575,769,2018,1694,19275,5489,5081,2955,10200,3531,8807,3148,1393,1473,845,1039,548,870,2022,1607,1972,1597
48015,23895,5555,11786,3192,2907,1636,7756,2333,7336,2210,420,607,92,337,328,528,299,447,824,780,12109,3203,2440,1659,7349,2283,6875,2154,474,586,291,484,183,354,1219,982,1101,944
48017,5658,1909,2951,1263,1176,789,1344,704,1003,518,341,413,170,286,171,223,103,176,328,350,2707,931,956,662,1287,597,1119,541,168,258,61,148,107,211,281,214,183,236
48019,19124,4418,9366,2635,2511,1581,5400,1554,5019,1466,381,489,93,237,288,425,262,380,1193,951,9758,2556,1560,1104,5464,1595,4951,1498,513,626,243,405,270,385,1023,783,1711,1177
48021,66889,17232,33797,10083,11786,6061,17014,5816,15129,5311,1885,1949,447,960,1438,1695,919,1368,4078,3416,33092,9819,9092,5484,16569,5803,14956,5279,1613,1905,600,1101,1013,1482,3026,2496,4405,3328
48023,2932,786,1400,420,276,246,832,332,795,332,37,73,17,69,20,65,134,134,158,144,1532,486,268,216,851,355,785,339,66,102,59,104,7,68,294,233,119,126
48025,26874,7125,17024,4739,8025,3273,6313,2467,4291,2004,2022,1055,461,574,1561,846,364,524,2322,1197,9850,3634,2917,2006,4627,2063,4115,1884,512,710,320,580,192,499,1103,1070,1203,1116
48027,266313,58964,132259,35763,45208,23346,71957,22872,63468,19895,8489,9401,2412,4616,6077,7738,3015,4679,12079,10165,134054,33780,36837,21041,70723,21094,61768,19336,8955,8791,3954,5800,5001,6355,9724,8471,16770,11492
48029,1533596,372181,750596,223657,308861,158403,351373,120269,304873,104138,46500,52257,18214,30604,28286,39467,17496,27523,72866,62998,783000,219513,265475,141029,350965,117498,300107,102016,50858,53370,25364,35380,25494,36636,60175,52200,106385,74465
48031,9800,2076,4922,1149,1166,644,2987,919,2717,851,270,300,91,155,179,246,255,262,514,342,4878,1262,805,534,2800,905,2515,811,285,290,126,175,159,218,530,396,743,441
48033,458,87,222,48,20,16,156,38,143,37,13,13,0,14,13,13,18,11,28,16,236,55,53,33,141,34,134,34,7,6,0,14,7,6,26,15,16,12
48035,15091,2677,7335,1560,1652,798,4514,1087,4321,1067,193,231,62,208,131,202,321,323,848,572,7756,1467,1273,614,4688,1134,4337,1071,351,366,143,248,208,274,998,524,797,491
48037,74984,20876,37531,12378,12569,7768,18626,7125,16087,6343,2539,2419,976,1778,1563,1778,1188,1803,5148,4219,37453,11804,9698,6612,18342,6991,16282,6349,2060,2487,1101,1738,959,1772,4275,3545,5138,4059
48039,281192,62902,141649,36863,44368,23442,80865,23529,73026,21629,7839,7794,2300,3958,5539,6628,3142,4710,13274,10495,139543,35402,35332,19650,78488,23008,72102,21399,6386,7552,2617,4771,3769,5617,11155,9302,14568,11412
48041,184306,40252,93011,26822,49482,21797,36904,12379,32536,10934,4368,5000,1224,2764,3144,4085,1189,2511,5436,5426,91295,24354,42087,18573,35916,11959,31469,10423,4447,5090,1851,3123,2596,3868,4726,4617,8566,6850
48043,7715,2071,3856,1204,1297,738,1975,770,1837,737,138,205,57,158,81,162,40,131,544,411,3859,1197,1085,697,1786,698,1689,680,97,165,52,141,45,146,399,343,589,454
48045,1265,105,698,79,233,79,351,50,318,49,33,24,28,25,5,8,32,16,82,38,567,59,109,35,315,52,298,49,17,16,0,14,17,16,90,33,53,27
48047,5559,2052,3044,1437,1615,1045,1104,609,775,455,329,353,110,199,219,282,78,138,247,239,2515,909,894,533,1018,490,790,445,228,227,175,204,53,126,252,209,351,334
48049,31139,7137,15220,4241,4288,2617,8167,2584,7552,2431,615,776,333,621,282,589,649,724,2116,1503,15919,4213,3401,2080,8730,2632,7920,2428,810,956,324,632,486,749,1835,1254,1953,1440
48051,14794,3721,7240,2112,1907,1252,4392,1464,4070,1382,322,442,145,307,177,331,227,332,714,654,7554,2159,1562,1075,4508,1559,3940,1355,568,616,205,369,363,454,770,567,714,567
48053,38526,10422,18886,6013,4960,3340,11180,3685,10309,3445,871,1089,265,586,606,905,482,782,2264,2020,19640,6013,3764,2921,10847,3775,10113,3424,734,1042,201,576,533,900,2418,1748,2611,2033
48055,33920,8312,17027,4816,6353,3081,8612,2996,7463,2586,1149,1264,338,567,811,1059,311,512,1751,1391,16893,4805,4766,2499,8044,2804,6617,2322,1427,1293,448,703,979,1024,1932,1350,2151,1490
48057,17215,4863,8798,2866,2698,1754,4772,1954,4208,1691,564,737,252,486,312,553,299,422,1029,964,8417,2709,2127,1410,4448,1702,3845,1538,603,720,228,409,375,589,699,581,1143,1038
48059,11323,2338,5566,1409,1508,842,3175,936,2963,904,212,258,87,187,125,233,242,242,641,473,5757,1345,1160,694,3173,936,2884,865,289,336,158,247,131,231,683,461,741,529
48061,314707,75366,150566,43367,55117,27861,81578,26087,72545,23991,9033,9577,3199,5553,5834,7844,4329,6158,9542,9468,164141,43337,50261,26111,83168,25529,67911,22340,15257,12605,7646,8384,7611,8669,15904,12343,14808,11473
48063,10022,2140,4695,1295,1163,718,2817,847,2612,791,205,275,69,168,136,210,219,245,496,418,5327,1206,1307,757,2835,847,2522,808,313,324,208,275,105,165,672,409,513,413
48065,4796,941,2322,529,533,321,1484,366,1391,342,93,121,43,105,50,90,66,90,239,168,2474,543,444,313,1507,375,1437,372,70,113,22,89,48,107,266,189,257,181
48067,24480,7070,11647,3834,2744,1996,6638,2571,6178,2493,460,675,161,445,299,578,534,702,1731,1437,12833,4111,2423,1749,6851,2614,6299,2505,552,752,254,556,298,620,1970,1521,1589,1324
48069,5767,1375,2923,907,909,489,1434,527,1249,479,185,203,129,181,56,109,115,119,465,368,2844,789,738,421,1359,468,1266,460,93,131,36,117,57,107,234,194,513,385
48071,31821,6844,16027,4040,4605,2672,9746,2697,9399,2604,347,552,150,397,197,449,347,523,1329,1267,15794,3804,3554,2135,9891,2692,9199,2586,692,779,199,404,493,686,1296,1108,1053,1023
48073,41072,9924,20886,5846,6803,3510,10916,3792,9719,3532,1197,1243,464,753,733,988,577,792,2590,1856,20186,5557,4614,2822,10707,3723,9784,3536,923,1074,476,773,447,786,2419,1741,2446,1919
48075,6118,1666,3793,1134,1803,739,1452,678,1209,584,243,227,69,107,174,198,53,122,485,446,2325,812,320,338,1247,555,1200,546,47,102,10,98,37,99,551,498,207,273
48077,8677,1581,4323,933,897,507,2689,658,2524,618,165,205,24,147,141,196,285,254,452,315,4354,926,745,442,2722,692,2585,660,137,185,55,142,82,158,432,311,455,320
48079,2252,332,1161,192,393,144,573,126,539,120,34,38,14,33,20,25,48,40,147,90,1091,187,261,140,590,129,520,125,70,44,62,42,8,25,131,79,109,59
48081,2756,441,1343,266,292,144,861,216,800,206,61,59,22,47,39,49,73,60,117,79,1413,274,107,92,897,228,823,218,74,88,14,39,60,86,187,122,222,104
48083,6879,2029,3517,1150,693,535,2215,863,2037,782,178,241,40,152,138,237,82,150,527,495,3362,1109,508,428,1999,850,1767,743,232,323,105,225,127,239,460,378,395,386
48085,764266,154129,372427,90965,111457,58887,229356,57360,217081,53899,12275,16520,3243,9491,9032,14263,5408,10657,26206,23378,391839,88599,99302,52845,226735,56177,210906,52206,15829,18903,6280,11765,9549,14531,23264,21487,42538,29579
48087,2333,689,1127,374,305,179,712,269,579,215,133,126,32,55,101,115,0,56,110,105,1206,376,237,151,676,251,563,226,113,126,28,55,85,109,207,133,86,75
48089,16990,4750,8425,2866,2650,1828,4789,1912,4389,1823,400,590,253,479,147,360,270,421,716,740,8565,2676,2349,1553,4111,1634,3823,1571,288,459,123,330,165,365,1081,865,1024,884
48091,115298,21531,56453,12760,15586,8414,34468,7992,32485,7551,1983,2420,810,1568,1173,1847,1173,1743,5226,4048,58845,12394,12775,7075,34430,7927,32093,7403,2337,2597,1069,1775,1268,1969,4706,3525,6934,4659
48093,11057,2711,5539,1577,1225,813,3534,1174,3338,1132,196,310,106,257,90,240,178,243,602,451,5518,1564,974,666,3335,1117,3054,1063,281,343,27,199,254,333,670,486,539,430
48095,2856,637,1838,583,748,423,845,223,462,166,383,108,46,70,337,110,53,45,192,113,1018,202,147,111,613,161,576,159,37,43,34,43,3,32,131,78,127,87
48097,32215,7918,15847,4544,4430,2727,9124,3016,8538,2948,586,756,268,585,318,579,519,747,1774,1503,16368,4576,3471,2272,9337,3108,8711,2882,626,859,306,610,320,653,1654,1162,1906,1450
48099,60334,12195,29997,7498,11408,4600,14214,4373,12272,3812,1942,1670,579,1030,1363,1350,906,1144,3469,2591,30337,6858,8326,4023,15075,4233,12019,3728,3056,1865,1250,1186,1806,1427,2304,1754,4632,2650
48101,1237,305,526,176,149,111,304,113,280,108,24,42,3,32,21,41,6,23,67,60,711,214,151,94,359,141,272,100,87,95,68,79,19,51,133,83,68,54
48103,3573,1010,1820,551,571,322,1123,390,1076,385,47,79,21,75,26,65,49,89,77,91,1753,552,352,240,1039,416,843,351,196,172,121,154,75,100,231,177,131,119
48105,2799,1173,1436,693,471,431,896,492,793,467,103,169,0,70,103,169,49,107,20,58,1363,620,287,281,864,464,817,460,47,88,25,96,22,79,115,175,97,140
48107,4533,735,2209,414,729,296,1239,274,1109,264,130,115,50,80,80,106,73,86,168,117,2324,469,575,290,1092,256,967,237,125,126,102,118,23,64,291,163,366,181
48109,1678,668,941,459,478,328,334,204,288,173,46,88,45,99,1,45,41,62,88,113,737,352,247,212,378,220,302,191,76,85,27,58,49,80,82,86,30,52
48111,5281,1495,2745,867,857,516,1603,601,1413,576,190,206,30,72,160,196,45,114,240,208,2536,786,550,408,1553,607,1391,550,162,194,84,137,78,145,166,143,267,225
48113,2029463,509126,990737,304666,399423,208114,486774,176892,423940,156673,62834,71868,21238,41046,41596,57679,20195,36970,84345,76882,1038726,296259,361036,191055,482287,172514,417753,154166,64534,70316,33408,49099,31126,48390,69556,64359,125847,92991
48115,10013,2424,5488,1481,2332,870,2513,952,2028,849,485,353,180,290,305,259,162,250,481,424,4525,1399,1198,774,2316,918,2090,852,226,332,77,237,149,291,494,407,517,435
48117,13826,3847,6890,2207,2334,1353,3850,1456,3529,1399,321,471,192,369,129,314,201,343,505,535,6936,2191,1652,1109,4122,1581,3563,1417,559,627,346,474,213,418,562,534,600,579
48119,4244,703,2067,394,499,245,1253,273,1171,255,82,78,9,54,73,76,105,136,210,161,2177,415,456,249,1306,276,1168,254,138,101,36,52,102,95,219,130,196,125
48121,661436,120579,322052,73446,107093,51563,183519,42870,171773,39549,11746,14685,4038,8589,7708,11908,4925,8976,26515,21380,339384,72056,98169,45474,181747,42449,166725,38574,15022,16914,6685,10948,8337,11994,19271,16919,40197,26084
48123,16533,3610,8709,2051,2477,1268,4807,1398,3995,1256,812,497,260,316,552,430,251,323,1174,711,7824,2091,1392,943,4634,1492,4279,1447,355,429,145,344,210,303,1024,714,774,631
48125,1852,276,907,156,236,118,552,146,444,116,108,64,51,65,57,51,16,31,103,68,945,190,115,67,472,121,408,109,64,61,40,45,24,46,194,98,164,90
48127,7818,2618,3761,1554,1769,1106,1600,809,1359,684,241,357,40,112,201,329,123,191,269,297,4057,1484,1198,846,1967,856,1596,738,371,368,205,311,166,264,340,297,552,564
48129,2791,410,1400,267,480,175,711,169,611,153,100,72,58,45,42,66,66,67,143,84,1391,250,347,185,648,155,600,159,48,55,29,49,19,35,196,101,200,107
48131,8780,2792,4517,1844,2061,1277,1890,869,1593,789,297,312,70,173,227,280,130,246,436,471,4263,1488,1353,892,1894,854,1629,798,265,342,132,243,133,241,526,461,490,435
48133,15128,4651,7578,2963,2793,1944,3386,1556,3023,1435,363,567,149,381,214,442,331,482,1068,985,7550,2683,1597,1296,3802,1707,3457,1563,345,518,155,401,190,403,966,842,1185,1132
48135,119303,36261,60417,21269,22138,14249,30058,12314,26241,11074,3817,4601,1213,2548,2604,3830,1328,2509,6893,6501,58886,20640,16886,11897,30047,12326,26069,10975,3978,4817,1962,3197,2016,3392,4884,4911,7069,6381
48137,1660,374,845,238,228,155,413,144,409,145,4,19,1,17,3,19,70,57,134,101,815,245,138,108,407,167,345,144,62,74,30,57,32,63,149,86,121,98
48139,135562,28613,66093,16351,19646,10324,39902,10290,37355,9690,2547,3054,1080,2085,1467,2286,1395,2280,5150,4280,69469,16428,16800,9310,40345,10422,37411,9718,2934,3496,1439,2330,1495,2409,4510,3855,7814,5802
48141,645455,163019,314760,94836,121886,64151,157463,55161,137663,49792,19800,21543,8390,13894,11410,15822,7800,12723,27611,25058,330695,95762,106713,59776,156977,53875,131118,47163,25859,25518,14138,18154,11721,16433,27775,24202,39230,29741
48143,34489,10179,16497,6408,6708,4617,8040,3030,7620,2845,420,716,76,460,344,693,418,726,1331,1376,17992,5778,6527,3920,8263,3165,7481,2892,782,939,239,573,543,754,1261,1288,1941,1654
48145,14143,3274,6543,2000,2464,1395,2953,1030,2570,933,383,433,258,364,125,252,288,347,838,686,7600,1950,2453,1186,3255,1088,2366,856,889,576,379,407,510,441,891,640,1001,590
48147,28540,5625,15210,3549,4655,2024,8094,2198,6855,1941,1239,918,301,507,938,756,499,674,1962,1294,13330,3050,2496,1488,7771,2058,7254,1986,517,618,205,415,312,522,1539,1020,1524,1043
48149,20837,5702,10111,3170,2569,1742,6201,2148,5776,2009,425,629,153,477,272,515,350,543,991,903,10726,3303,2509,1766,5780,2116,5411,1966,369,596,132,423,237,532,1359,1067,1078,974
48151,3118,547,1494,343,408,224,879,227,839,223,40,79,29,71,11,59,39,45,168,108,1624,322,363,200,846,229,804,225,42,52,35,58,7,52,270,138,145,105
48153,4516,1066,2188,592,591,306,1377,443,1310,429,67,127,18,114,49,121,46,102,174,175,2328,611,470,293,1431,448,1287,412,144,140,103,124,41,110,258,193,169,158
48155,1117,120,564,63,173,55,319,55,294,56,25,21,3,6,22,20,33,27,39,31,553,82,147,69,293,53,272,57,21,21,3,4,18,21,75,34,38,21
48157,591289,98927,286731,57835,87563,38465,177598,35685,165658,33242,11940,11446,3272,6055,8668,9192,3917,5915,17653,14176,304558,56985,80020,35513,176821,35029,161804,32094,15017,13408,6452,8722,8565,9369,19034,13941,28683,17896
48159,8657,1907,4156,1029,947,512,2425,771,2364,770,61,140,0,98,61,140,169,204,615,403,4501,1168,1104,606,2391,749,2209,742,182,209,76,157,106,162,446,365,560,433
48161,16107,3093,8336,1744,2532,1110,4395,1273,3661,1174,734,567,214,294,520,466,344,334,1065,551,7771,1816,1602,927,4323,1288,3904,1238,419,432,180,292,239,336,976,674,870,621
48163,16140,4783,9914,3301,5114,2321,3656,1548,2750,1425,906,502,180,290,726,420,195,340,949,914,6226,2309,2332,1587,2815,1412,2347,1191,468,643,269,461,199,378,496,493,583,605
48165,14384,3972,7383,2314,2232,1280,4502,1513,4039,1397,463,518,222,372,241,363,176,331,473,524,7001,2098,1549,1030,4278,1450,3807,1350,471,506,176,354,295,398,578,526,596,559
48167,265687,61587,129506,35930,41634,23080,70528,21909,65591,20743,4937,6284,2051,4240,2886,4976,3480,5032,13864,11474,136181,35463,36530,20373,70805,21866,64030,20125,6775,7675,3178,5252,3597,5395,11238,9105,17608,12225
48169,5351,1160,3516,715,1300,437,1899,462,964,371,935,199,271,124,664,166,41,73,276,161,1835,607,520,373,967,377,919,372,48,86,27,81,21,75,227,193,121,126
48171,22135,4706,10567,2697,2601,1594,6486,1926,6151,1878,335,519,68,278,267,479,572,637,908,747,11568,2696,2207,1356,6392,1899,5956,1846,436,516,132,346,304,444,1639,1058,1330,952
48173,1231,384,649,244,150,99,482,190,361,112,121,144,0,28,121,144,17,41,0,28,582,198,153,113,397,145,340,112,57,76,0,28,57,76,15,32,17,15
48175,6196,1388,3026,795,845,483,1811,583,1726,548,85,132,41,108,44,111,88,126,282,257,3170,817,725,464,1733,517,1700,512,33,86,21,80,12,75,419,277,293,295
48177,16071,3406,8066,2002,2526,1209,4507,1254,4043,1208,464,476,92,247,372,445,285,329,748,552,8005,1878,1882,1068,4398,1256,4103,1214,295,376,138,289,157,275,833,571,892,665
48179,17609,4312,9362,2649,2794,1498,4957,1758,4342,1596,615,605,223,430,392,523,299,470,1312,992,8247,2482,1884,1382,4225,1516,3795,1435,430,579,232,472,198,448,1092,868,1046,924
48181,105118,25394,50685,15051,14774,8899,27008,9251,24920,8592,2088,2853,925,1945,1163,2188,1746,2459,7157,5554,54433,14860,12819,8193,27089,9146,24812,8568,2277,2926,1132,2059,1145,2079,6218,4702,8307,5613
48183,96496,26309,46360,15192,16663,9943,23160,9187,20648,8337,2512,3311,1153,2310,1359,2381,1396,2382,5141,4687,50136,15819,13475,9263,23633,9330,21014,8455,2619,3313,1396,2467,1223,2334,5046,4313,7982,6226
48185,22808,5512,12636,3341,4488,2036,5910,1931,4843,1720,1067,672,304,472,763,518,450,482,1788,1067,10172,2968,2572,1745,5603,1824,4810,1658,793,787,521,632,272,437,869,745,1128,880
48187,125960,24132,61648,14117,18873,9050,35579,8746,33421,8263,2158,2605,1079,1864,1079,1842,1872,2318,5324,4224,64312,14001,16035,8010,35178,8479,32420,7878,2758,2978,1369,2069,1389,2106,4937,3648,8162,5259
48189,26223,6757,13771,4099,4782,2442,7081,2641,6099,2384,982,983,359,612,623,810,369,591,1539,1259,12452,3896,3400,2312,6384,2326,5633,2096,751,1000,318,637,433,773,1331,1041,1337,1220
48191,2491,404,1219,246,347,151,647,156,595,164,52,43,14,20,38,35,72,57,153,77,1272,222,253,119,666,172,588,168,78,69,56,57,22,29,176,99,177,90
48193,6902,1748,3410,1046,1051,674,1869,677,1662,617,207,252,91,186,116,182,186,200,304,311,3492,977,668,445,1923,648,1833,640,90,153,31,138,59,134,534,400,367,296
48195,4214,1042,2087,613,601,377,1260,408,1119,378,141,156,36,88,105,140,106,127,120,138,2127,594,484,323,1264,385,1081,381,183,202,104,140,79,127,205,191,174,156
48197,3255,720,1600,406,308,180,937,285,877,268,60,76,55,76,5,52,55,83,300,184,1655,406,303,188,862,268,821,258,41,54,37,52,4,62,255,163,235,150
48199,45116,11895,21794,6710,5577,3750,12840,4504,11864,4142,976,1399,490,988,486,947,652,932,2725,2165,23322,6685,4199,2861,13165,4562,12018,4197,1147,1459,478,929,669,1108,2547,1932,3411,2523
48201,3601091,801846,1777080,485790,697204,340033,904323,282445,796753,252002,107570,112992,39879,65214,67691,85934,34228,56015,141325,125769,1824011,462083,611279,303338,884241,269361,768724,240737,115517,114113,59652,79017,55865,76055,122976,106575,205515,147834
48203,52659,15318,25501,8742,7711,5343,14308,5307,12992,4829,1316,1741,282,907,1034,1585,866,1397,2616,2465,27158,8843,6529,4637,14197,5337,12774,4791,1423,2001,694,1315,729,1431,2853,2463,3579,3034
48205,4667,577,2797,350,971,254,1211,334,921,287,290,129,112,89,178,108,113,102,502,148,1870,380,259,173,1317,333,1294,338,23,72,16,55,7,59,174,133,120,102
48207,4880,794,2591,531,902,324,1287,356,1056,314,231,196,79,107,152,134,76,98,326,220,2289,455,578,278,1078,289,936,290,142,113,75,97,67,84,330,178,303,182
48209,172082,36876,85082,22185,34323,16215,42532,12100,39203,11200,3329,3763,863,1885,2466,3255,1681,2391,6546,5419,87000,22179,31589,15018,41558,11941,38035,10849,3523,4149,1609,2673,1914,2883,4545,3919,9308,6137
48211,2976,654,1551,389,384,215,934,254,852,255,82,86,49,75,33,65,25,48,208,168,1425,383,286,203,902,284,863,259,39,87,0,56,39,87,101,99,136,119
48213,66815,15696,32225,9115,8368,5265,18499,5849,16928,5441,1571,1928,436,947,1135,1675,1341,1584,4017,2995,34590,8942,6757,4461,18345,5753,16652,5394,1693,1853,868,1321,825,1245,4381,3016,5107,3507
48215,619974,152929,299062,86461,114376,55071,159688,52510,142076,48257,17612,18014,6695,10578,10917,13524,6437,9658,18561,18112,320912,87843,103172,52014,163038,51815,134599,45739,28439,23892,14763,16172,13676,16031,25184,21059,29518,23322
48217,28854,4813,14198,2739,3537,1553,7939,1819,7225,1687,714,634,310,419,404,498,554,488,2168,1172,14656,2779,3239,1455,8036,1855,7254,1708,782,665,334,439,448,520,1667,893,1714,965
48219,18104,3705,8950,2161,2858,1343,5069,1449,4633,1358,436,481,197,351,239,335,324,351,699,552,9154,2176,2278,1172,4856,1403,4402,1346,454,494,229,348,225,347,1145,724,875,616
48221,48244,10082,23350,5963,5124,3084,14961,3979,14009,3681,952,1212,356,746,596,966,774,922,2491,1873,24894,5745,4114,2845,14603,3876,13424,3549,1179,1393,353,699,826,1191,2647,1912,3530,2403
48223,28992,6049,14041,3515,3614,1955,8474,2461,7853,2253,621,816,244,523,377,661,466,597,1487,1148,14951,3434,3044,1762,8362,2323,7579,2102,783,882,497,739,286,503,1669,1106,1876,1234
48225,19247,4331,10548,2620,3522,1634,4950,1644,3992,1508,958,523,300,434,658,409,432,491,1644,945,8699,2437,1966,1332,4430,1528,4116,1464,314,471,170,393,144,354,1101,801,1202,954
48227,29553,6935,16685,4410,6212,2922,7556,2515,5542,2159,2014,1056,536,680,1478,852,680,773,2237,1517,12868,3994,3643,2536,5928,2348,5056,2011,872,1112,427,719,445,813,1387,1128,1910,1422
48229,3535,746,1813,489,575,292,1040,324,554,233,486,244,120,135,366,205,32,58,166,125,1722,380,514,252,896,283,664,270,232,184,133,116,99,151,262,128,50,56
48231,75603,16828,36863,9888,11787,6162,19384,5912,17789,5524,1595,2001,643,1289,952,1598,1008,1385,4684,3566,38740,9856,9395,5031,20561,6263,18234,5577,2327,2503,1071,1700,1256,1666,3818,2896,4966,3575
48233,16892,5036,8510,3156,2615,1813,4267,1704,3813,1493,454,646,182,460,272,492,206,418,1422,1370,8382,2744,2105,1526,4162,1583,3829,1472,333,584,267,546,66,342,898,760,1217,1041
48235,1230,214,637,130,175,92,366,112,366,112,0,28,0,28,0,28,39,41,57,52,593,130,103,68,362,100,341,95,21,31,0,28,21,31,50,37,78,58
48237,7315,1040,4190,712,1588,449,2091,459,1880,454,211,143,60,96,151,128,42,96,469,254,3125,540,524,257,1916,419,1773,409,143,148,101,120,42,97,348,209,337,213
48239,11635,3027,5776,1813,1642,1070,3277,1103,2882,1008,395,438,100,210,295,370,261,326,596,510,5859,1675,1388,842,3187,1077,2950,1034,237,299,100,202,137,243,593,495,691,546
48241,28384,8785,13824,4921,3592,2702,7647,3145,6704,2942,943,1089,344,664,599,864,633,834,1952,1588,14560,5337,3307,2661,7081,3101,6183,2731,898,1181,371,735,527,859,1946,1659,2226,1851
48243,1919,407,900,258,150,141,579,169,568,169,11,30,11,30,0,28,47,60,124,97,1019,246,158,147,664,191,621,182,43,68,0,28,43,68,61,54,136,139
48245,203109,54507,103935,33173,39780,21912,50045,19104,42069,16945,7976,7311,2565,4458,5411,5944,2948,4694,11162,9294,99174,30503,31019,18824,45850,17910,41513,16658,4337,5947,1882,4215,2455,4723,9557,8193,12748,10216
48247,3854,1126,1798,642,783,442,806,315,721,263,85,141,35,98,50,99,33,69,176,171,2056,650,779,429,846,314,754,278,92,133,53,119,39,73,155,142,276,202
48249,31410,10731,15343,6298,5891,3935,7605,3489,6810,3199,795,1074,299,677,496,850,466,824,1381,1527,16067,6079,5104,3515,7676,3475,6675,3148,1001,1216,494,810,507,876,1821,1516,1466,1456
48251,131294,29021,65040,17025,17970,10148,38344,11041,35368,10346,2976,3413,1067,2151,1909,2712,1758,2460,6968,5382,66254,16249,13961,8653,37897,10754,34893,10082,3004,3458,1043,2051,1961,2834,5429,4373,8967,6202
48253,17069,2888,11071,1782,4953,1034,4342,1290,2569,1070,1773,435,559,308,1214,373,320,334,1456,540,5998,1596,833,702,3928,1373,3624,1326,304,403,149,314,155,271,700,555,537,435
48255,12849,2904,7696,1853,3287,1163,3343,1138,2403,934,940,542,325,322,615,397,204,275,862,558,5153,1808,1484,952,2571,1003,2245,848,326,407,95,247,231,347,629,491,469,459
48257,95437,19256,46418,11342,14338,7114,26354,6693,24244,6253,2110,2260,866,1432,1244,1769,1087,1476,4639,3731,49019,11315,12465,6383,26043,6745,23058,5898,2985,2999,1484,1977,1501,2001,3925,2993,6586,4123
48259,35508,8277,17363,4977,4750,2889,10472,3082,9872,2876,600,894,193,517,407,688,448,727,1693,1743,18145,4587,3799,2353,10591,3064,9832,2819,759,1035,438,742,321,691,1740,1284,2015,1731
48261,404,151,172,86,34,48,84,67,84,67,0,28,0,28,0,28,27,54,27,46,232,96,21,37,112,73,88,68,24,48,24,48,0,28,83,68,16,33
48263,524,75,225,45,31,16,145,38,130,40,15,12,10,10,5,8,13,16,36,25,299,55,46,33,149,44,147,43,2,4,0,14,2,4,73,35,31,20
48265,43665,9755,20859,5578,5771,3208,11628,3614,10919,3512,709,912,183,540,526,835,959,1102,2501,1926,22806,5709,4224,2867,12314,3919,11296,3732,1018,1208,448,814,570,872,2832,1973,3436,2349
48267,3670,761,1761,468,377,269,1101,325,1014,312,87,102,10,57,77,105,24,60,259,247,1909,431,274,182,1099,313,993,302,106,115,6,66,100,109,305,182,231,174
48269,175,54,82,30,6,7,54,20,37,17,17,10,1,3,16,10,9,10,13,20,93,39,29,27,38,15,34,15,4,4,0,14,4,4,7,10,19,20
48271,3319,889,1943,682,750,425,749,316,564,270,185,173,94,125,91,112,42,91,402,369,1376,407,238,180,524,265,458,224,66,93,30,71,36,76,435,283,179,196
48273,24741,7148,12511,4199,5697,2871,5355,2420,4684,2214,671,826,338,608,333,536,241,464,1218,1180,12230,4293,5042,3138,5059,2216,4333,2021,726,944,351,638,375,648,1237,1251,892,898
48275,2863,547,1428,337,368,192,798,222,714,198,84,82,26,35,58,70,104,92,158,100,1435,286,277,155,819,211,722,191,97,91,41,51,56,78,234,107,105,75
48277,39852,9523,18815,5502,5048,3376,10489,3621,9679,3270,810,1184,217,675,593,1016,740,950,2538,1946,21037,5606,4816,3122,10723,3578,9670,3308,1053,1204,482,808,571,933,2361,1713,3137,2211
48279,10057,2012,5005,1206,1637,732,2624,763,2416,721,208,264,124,217,84,193,154,218,590,429,5052,1122,1161,621,2679,778,2417,712,262,280,147,218,115,209,684,435,528,404
48281,17173,3740,8646,2286,2242,1375,5566,1490,5081,1384,485,570,219,369,266,397,194,269,644,583,8527,2117,1361,979,4959,1393,4482,1256,477,584,194,355,283,437,939,707,1268,837
48283,6232,1965,3676,1252,1322,766,1679,730,1275,630,404,281,47,99,357,250,336,405,339,266,2556,973,731,477,1377,650,1270,623,107,173,50,112,57,124,200,236,248,243
48285,16034,3247,7768,1838,2143,1082,4863,1335,4536,1277,327,383,121,341,206,316,202,269,560,480,8266,1842,1761,930,4516,1212,4363,1189,153,278,53,250,100,257,1135,703,854,561
48287,13989,3571,7076,2206,2465,1409,3882,1313,3503,1243,379,421,129,282,250,348,133,275,596,615,6913,1984,1427,1060,3816,1356,3619,1320,197,331,83,234,114,259,771,637,899,760
48289,13974,3573,6912,1994,1862,1039,3789,1371,3452,1319,337,429,32,177,305,416,322,405,939,700,7062,2056,1253,986,3782,1391,3297,1297,485,566,275,386,210,356,884,628,1143,800
48291,65523,17793,32022,11109,9712,6507,18017,6782,16157,6288,1860,2066,918,1500,942,1373,843,1315,3450,3072,33501,9689,8910,5007,17022,6161,14215,5554,2807,2092,1435,1510,1372,1388,3228,2496,4341,3055
48293,19086,3665,9819,2332,3595,1593,4828,1381,4338,1284,490,478,259,397,231,312,326,376,1070,750,9267,2143,2040,1076,4851,1345,4376,1259,475,460,245,317,230,347,1189,792,1187,874
48295,2632,208,1270,117,364,104,747,110,680,107,67,49,12,28,55,45,27,22,132,59,1362,170,290,105,748,120,689,114,59,51,19,14,40,47,136,60,188,65
48297,10140,2456,5608,1436,1957,888,2681,942,2134,863,547,284,199,224,348,240,262,289,708,508,4532,1530,1203,877,2231,869,2076,839,155,210,92,175,63,155,653,535,445,400
48299,18411,4616,8869,2479,1784,1238,5329,1709,4990,1635,339,467,195,387,144,315,561,578,1195,960,9542,2766,1372,1064,5295,1785,4750,1584,545,641,342,560,203,382,1422,1021,1453,1107
48301,73,31,45,22,14,15,22,12,22,12,0,14,0,14,0,14,2,4,7,9,28,13,0,14,19,10,19,10,0,14,0,14,0,14,3,5,6,9
48303,243587,59100,119163,36710,50306,28245,54373,18663,49680,17346,4693,6180,1830,4136,2863,4918,2904,4788,11580,10048,124424,35973,43100,24650,56518,19746,50061,17591,6457,7680,3132,5373,3325,5526,9097,7802,15709,11603
48305,4496,485,2357,304,687,213,1410,238,1320,227,90,73,63,65,27,37,102,71,158,104,2139,325,435,170,1278,235,1129,222,149,125,90,97,59,74,264,146,162,113
48307,6565,2051,3426,1254,1100,740,1684,779,1561,741,123,209,97,205,26,119,139,201,503,427,3139,1109,686,590,1627,728,1462,712,165,251,85,189,80,188,444,379,382,355
48309,199544,46391,96228,27967,37012,19501,47503,15275,43287,14173,4216,5219,1523,3388,2693,4167,2577,4037,9136,7820,103316,27369,34074,17511,47114,15236,41965,13763,5149,5965,2914,4548,2235,3833,9330,7403,12798,9037
48311,566,127,322,99,90,64,202,45,144,38,58,31,0,14,58,31,8,8,22,25,244,64,30,24,157,46,143,39,14,23,14,23,0,14,47,25,10,13
48313,11747,2558,6874,1644,2863,1031,3029,970,2194,778,835,372,160,211,675,341,227,247,755,431,4873,1307,1088,634,2583,842,2332,782,251,298,112,191,139,258,605,415,597,436
48315,8543,1909,4157,1134,968,565,2472,829,2309,781,163,237,0,140,163,237,234,302,483,413,4386,1101,759,493,2472,795,2303,795,169,218,71,162,98,182,695,457,460,351
48317,4186,991,2210,581,616,306,1230,421,1204,419,26,49,19,46,7,36,146,127,218,191,1976,529,447,294,1205,390,1059,351,146,119,92,115,54,70,130,117,194,181
48319,3376,895,1678,588,434,335,1076,432,924,375,152,198,23,81,129,196,50,99,118,123,1698,507,326,278,913,351,818,301,95,151,71,145,24,76,224,186,235,185
48321,28839,9728,14332,5461,4110,2890,8070,3443,7044,3118,1026,1302,242,748,784,1093,596,936,1556,1604,14507,5620,3194,2735,8461,3796,7616,3583,845,1252,421,906,424,851,1475,1493,1377,1474
48323,42985,12835,21291,7500,7566,4748,11685,4636,10072,4087,1613,1769,702,1003,911,1257,514,900,1526,1651,21694,7148,6643,4018,11344,4166,8982,3592,2362,2063,1204,1472,1158,1428,2013,1794,1694,1769
48325,40581,10450,21063,6246,7113,3630,11451,3889,9706,3228,1745,1774,424,681,1321,1476,595,732,1904,1672,19518,5818,5099,2963,10851,3562,9727,3218,1124,1168,316,591,808,996,1397,1109,2171,1868
48327,1885,465,1022,298,266,166,558,211,517,208,41,68,1,30,40,68,89,113,109,82,863,247,116,102,526,202,493,203,33,53,18,43,15,47,123,93,98,103
48329,127335,35200,64036,21106,20781,13383,34198,12867,30295,11411,3903,4936,989,2195,2914,4293,1337,2385,7720,6946,63299,19744,16589,11120,34168,12319,30764,11230,3404,4283,1539,2691,1865,3319,4966,4633,7576,6686
48331,20003,4959,9893,2816,2998,1747,5214,1823,4752,1690,462,577,140,378,322,471,516,524,1165,909,10110,2903,2242,1595,5492,1895,5003,1716,489,637,249,490,240,431,1169,807,1207,892
48333,4090,1039,1907,587,335,266,1131,431,1016,386,115,130,44,114,71,107,85,110,356,295,2183,614,442,325,1079,334,919,324,160,172,34,85,126,164,324,213,338,245
48335,7225,1918,4476,1305,2132,803,1679,666,1265,584,414,217,59,111,355,210,85,120,580,452,2749,867,693,464,1356,611,1183,554,173,243,72,176,101,151,400,319,300,286
48337,15710,4355,7671,2615,1801,1312,4537,1717,4369,1685,168,333,62,290,106,329,294,417,1039,1013,8039,2381,1549,1124,4473,1671,4203,1611,270,438,102,352,168,352,957,839,1060,917
48339,446846,96567,219298,55269,62897,34966,132392,35307,123915,33228,8477,9754,3123,5747,5354,7329,4831,6616,19178,16347,227548,56059,54854,32358,130030,34635,120105,32179,9925,11310,4946,7399,4979,7336,16945,13637,25719,18345
48341,15606,4159,8099,2509,2541,1568,4954,1711,4525,1644,429,477,110,284,319,409,274,403,330,412,7507,2207,1795,1307,4320,1404,3747,1330,573,550,185,331,388,479,560,510,832,738
48343,9989,2964,4642,1691,1033,791,2941,1167,2733,1107,208,290,130,252,78,206,165,309,503,442,5347,1694,1013,743,2842,1123,2541,1055,301,332,136,247,165,254,609,505,883,632
48345,987,191,561,131,171,74,284,91,241,76,43,55,17,36,26,49,34,31,72,40,426,99,70,46,234,69,214,66,20,22,13,18,7,25,66,36,56,42
48347,52589,11522,24818,6696,9758,4611,12163,3885,10983,3594,1180,1342,696,1096,484,810,683,918,2214,1765,27771,7033,10419,4601,12168,3900,10926,3587,1242,1424,762,1108,480,894,2537,1891,2647,1927
48349,38311,9583,18627,5542,5594,3160,10098,3301,9090,3052,1008,1136,224,525,784,1036,785,949,2150,1689,19684,5434,4601,3058,10527,3482,9399,3191,1128,1200,474,742,654,959,2198,1539,2358,1701
48351,11659,3519,6026,2169,1837,1241,3254,1343,2911,1290,343,459,186,310,157,327,233,307,702,616,5633,1755,1145,832,2968,1223,2612,1174,356,414,175,284,181,303,662,579,858,701
48353,11654,2882,6006,1940,1948,1179,3056,1084,2789,1006,267,432,76,282,191,387,280,407,722,628,5648,1550,952,740,3189,1076,2816,996,373,418,243,373,130,334,743,579,764,574
48355,287488,74079,140569,44219,53023,29549,67726,24432,60328,22315,7398,9185,2498,5316,4900,7518,3684,5883,16136,13748,146919,42307,44175,25169,70060,25201,61492,22706,8568,9585,4257,6799,4311,6642,13387,11239,19297,14718
48357,7502,1909,3771,1058,1168,600,2338,782,2183,772,155,202,95,190,60,134,127,174,138,187,3731,1067,857,547,2304,780,2154,765,150,213,112,204,38,124,239,269,331,297
48359,1554,257,776,152,217,87,431,102,417,99,14,16,3,17,11,16,8,10,120,74,778,180,242,167,427,94,396,95,31,38,2,18,29,38,44,29,65,37
48361,66762,17685,32725,10049,9185,5638,18317,6500,17142,6088,1175,1865,462,1229,713,1511,1136,1551,4087,3475,34037,10112,7178,4930,18801,6597,17405,6275,1396,1937,731,1493,665,1377,3243,2770,4815,3759
48363,23018,5738,11135,3334,3091,1963,5980,2000,5303,1800,677,829,311,550,366,611,524,667,1540,1236,11883,3276,2614,1740,6038,1978,5498,1842,540,690,293,510,247,494,1498,1018,1733,1234
48365,18772,5181,9198,2924,2633,1737,5278,1879,4823,1728,455,601,247,459,208,428,290,461,997,881,9574,2988,2259,1590,5114,1862,4772,1770,342,544,174,406,168,417,1153,1006,1048,941
48367,106603,20255,52550,11910,13518,7122,31732,7250,29904,6858,1828,2086,628,1191,1200,1622,1666,1997,5634,3967,54053,11634,11609,6495,31282,7189,29219,6768,2063,2303,615,1188,1448,1880,4585,3399,6577,4451
48369,7328,1698,3775,1059,1288,688,2152,669,1918,632,234,269,56,157,178,235,69,131,266,226,3553,916,864,469,2072,638,1845,581,227,265,108,166,119,206,431,291,186,194
48371,12523,3565,7293,2190,2826,1385,3420,1289,2699,1181,721,488,269,391,452,313,139,272,908,561,5230,1875,1415,1023,2844,1147,2655,1130,189,298,137,284,52,197,533,482,438,479
48373,40709,9114,22207,5768,6370,2966,11677,3769,9728,3218,1949,1546,703,975,1246,1045,693,872,3467,2258,18502,4840,3810,2484,9988,3177,8920,2944,1068,1202,441,771,627,903,1836,1359,2868,1933
48375,91692,21790,47332,12983,16283,8395,23554,8528,19737,7663,3817,3347,1498,2234,2319,2537,1529,2093,5966,3952,44360,12815,12006,7447,22260,7990,19319,7318,2941,3183,1892,2589,1049,2036,4170,3557,5924,4393
48377,5427,1618,2612,986,812,721,1507,598,1172,526,335,319,118,207,217,267,123,192,170,227,2815,928,785,502,1355,627,1064,494,291,342,118,189,173,248,503,432,172,200
48379,9900,1750,4888,1089,1094,492,2968,692,2543,584,425,374,202,239,223,287,191,179,635,401,5012,944,842,422,2728,611,2546,582,182,182,88,135,94,112,640,372,802,415
48381,107182,24370,52165,14778,16242,9543,29730,9067,27802,8467,1928,2905,518,1771,1410,2517,1229,2109,4964,4602,55017,14475,13310,8215,29515,9136,26541,8053,2974,3852,1285,2502,1689,2805,4774,4001,7418,5622
48383,2658,688,1346,406,439,257,800,257,726,244,74,92,0,56,74,92,42,71,65,91,1312,393,350,210,765,244,720,237,45,79,16,65,29,66,58,81,139,152
48385,2684,584,1197,296,344,172,550,190,540,186,10,38,0,42,10,38,165,142,138,101,1487,432,398,241,540,193,510,189,30,31,7,26,23,39,243,130,306,234
48387,10197,2797,4806,1582,1238,848,2590,1029,2220,896,370,486,132,290,238,397,239,352,739,592,5391,1720,1196,919,2609,979,2410,943,199,297,148,276,51,211,865,661,721,584
48389,12658,3537,7331,2249,2936,1660,3506,1227,2079,976,1427,600,325,328,1102,509,229,233,660,519,5327,2069,1433,1106,2740,1206,2329,981,411,562,285,461,126,246,490,442,664,634
48391,5789,1292,2813,818,1020,561,1325,431,1235,421,90,130,51,108,39,110,142,151,326,235,2976,790,771,489,1386,454,1176,409,210,215,132,192,78,140,439,288,380,268
48393,648,87,300,48,62,33,211,42,207,42,4,7,4,7,0,14,2,4,25,15,348,56,84,33,213,39,200,40,13,11,10,10,3,4,17,9,34,23
48395,13620,3094,6517,1800,1822,1065,3623,1220,3307,1168,316,380,204,323,112,241,314,379,758,611,7103,1874,1706,1049,4010,1265,3460,1117,550,571,361,487,189,315,760,524,627,538
48397,75739,11648,37027,7068,9762,4595,24310,4611,23291,4496,1019,1146,240,581,779,1035,647,935,2308,1786,38712,6637,8292,4167,24407,4559,22754,4368,1653,1515,563,814,1090,1189,2548,1861,3465,2313
48399,8343,1800,4140,1105,1223,676,2263,670,2137,625,126,221,39,172,87,217,132,202,522,401,4203,1050,889,622,2271,671,2038,627,233,259,90,201,143,226,634,374,409,328
48401,43700,10123,23540,6094,7135,3611,12348,3823,10647,3581,1701,1342,556,892,1145,1058,844,1062,3213,2146,20160,5686,4519,2965,10658,3518,9679,3262,979,1174,502,860,477,874,2352,1741,2631,2079
48403,8884,2279,4246,1310,869,668,2529,879,2361,829,168,252,72,180,96,222,260,352,588,481,4638,1342,624,541,2734,950,2417,848,317,345,214,268,103,213,775,579,505,455
48405,6969,1690,3299,876,887,482,1873,642,1719,638,154,195,37,129,117,184,187,223,352,312,3670,1075,757,503,1927,743,1685,724,242,280,109,197,133,194,487,348,499,360
48407,22930,6295,11262,3478,2686,1807,6040,2347,5285,2105,755,869,232,393,523,700,651,653,1885,1428,11668,3727,2076,1456,6265,2308,5614,2197,651,794,426,608,225,475,1330,1158,1997,1603
48409,52002,11922,25954,7126,9211,4731,13370,4220,11967,3755,1403,1623,520,972,883,1316,851,1078,2522,2022,26048,6772,6826,3796,13534,4256,12202,3876,1332,1481,754,1140,578,973,2505,1870,3183,2336
48411,4993,938,2610,566,690,300,1479,418,1292,368,187,192,56,106,131,166,104,105,337,220,2383,604,620,339,1121,312,895,283,226,118,104,113,122,105,350,196,292,210
48413,2320,476,1172,273,294,183,646,209,644,209,2,31,0,42,2,31,14,43,218,169,1148,266,280,178,661,187,603,190,58,60,58,60,0,42,146,99,61,63
48415,13441,3229,7441,2038,2640,1478,3576,1245,3113,1161,463,397,250,363,213,285,176,264,1049,667,6000,1770,1179,834,3608,1288,3288,1252,320,413,146,300,174,319,653,620,560,565
48417,2690,582,1313,348,405,205,684,226,659,230,25,58,3,34,22,55,23,48,201,140,1377,332,241,150,807,255,724,245,83,97,42,62,41,73,193,142,136,124
48419,19831,5763,9774,3377,3000,2042,5396,2098,4807,1915,589,718,305,519,284,479,470,612,908,831,10057,3185,2600,1911,5437,2010,4841,1884,596,676,365,469,231,434,1030,850,990,906
48421,2525,338,1349,210,399,125,765,128,690,134,75,65,48,60,27,37,25,31,160,109,1176,170,230,95,687,142,602,126,85,70,23,24,62,66,129,65,130,72
48423,180770,46730,85768,27165,27921,17460,46830,15523,42401,14088,4429,5442,1403,2961,3026,4423,2182,3399,8835,7989,95002,27521,24990,15832,47165,15579,41739,13744,5426,6465,1832,3388,3594,5163,10030,7879,12817,9850
48425,7211,1857,3494,1000,703,495,2361,770,2249,726,112,200,39,134,73,136,95,132,335,299,3717,1152,926,599,1880,683,1746,665,134,165,76,133,58,118,370,288,541,407
48427,46347,13213,22343,7853,9182,5377,10931,4170,9500,3777,1431,1585,687,1101,744,1106,646,998,1584,1744,24004,7745,8121,4678,10988,4099,7846,3155,3142,2497,1798,1782,1344,1468,2467,2107,2428,2218
48429,7589,2016,4035,1305,1275,800,2162,824,1808,713,354,433,198,327,156,274,161,203,437,365,3554,1098,495,467,1907,723,1699,659,208,267,122,213,86,184,542,457,610,517
48431,916,103,498,68,151,49,312,53,216,49,96,37,58,13,38,34,5,13,30,21,418,59,22,16,244,47,214,50,30,22,9,11,21,21,51,33,101,51
48433,1152,223,574,125,132,75,385,111,356,105,29,38,0,28,29,38,41,31,16,18,578,130,70,68,374,103,328,87,46,43,25,39,21,30,66,48,68,49
48435,2932,712,1516,475,253,200,983,318,862,286,121,144,45,82,76,118,72,87,208,174,1416,387,243,217,884,290,834,283,50,74,30,71,20,59,63,79,226,166
48437,5934,1501,3207,977,1062,624,1734,679,1381,525,353,343,125,209,228,251,86,142,325,288,2727,799,689,426,1468,546,1173,427,295,283,217,277,78,135,391,270,179,183
48439,1597582,382201,772267,223454,274192,149019,408569,131356,371287,120352,37282,46491,13848,28381,23434,36340,16773,28580,72733,64568,825315,224045,253087,142326,407710,128838,366117,117910,41593,47796,19807,32482,21786,34175,56641,50661,107877,76335
48441,108290,28398,52205,16929,18930,11228,26908,9739,24485,8957,2423,3351,1053,2331,1370,2603,1494,2404,4873,4670,56085,16965,16799,10470,27096,9699,24275,8848,2821,3634,1712,2914,1109,2349,4945,3970,7245,5738
48443,783,185,363,110,51,56,246,74,188,63,58,40,0,14,58,40,23,19,43,36,420,103,31,36,269,95,191,68,78,78,34,44,44,55,72,43,48,40
48445,9609,2957,4958,1795,1555,977,2620,1160,2132,1037,488,483,242,347,246,337,187,279,596,552,4651,1680,1032,868,2546,1144,2248,1086,298,368,173,299,125,225,508,481,565,634
48447,1257,190,582,110,130,65,398,88,381,91,17,29,0,28,17,29,28,29,26,25,675,121,128,71,399,93,379,91,20,18,11,23,9,23,108,53,40,31
48449,24768,5669,12113,3262,3751,1873,7253,2175,6669,2034,584,676,226,439,358,534,273,427,836,755,12655,3141,3165,1723,7185,2027,6237,1894,948,827,435,577,513,632,1001,770,1304,987
48451,94268,25806,46752,15775,17011,10346,23456,9154,20886,8053,2570,3544,978,2206,1592,2772,1540,2414,4745,4589,47516,14866,13563,9202,22655,8778,20397,7892,2258,3229,1073,2354,1185,2315,3975,3500,7323,5616
48453,998887,194644,502916,126496,216022,93339,233282,69744,210016,62282,23266,26791,6823,14246,16443,22122,6996,13290,46616,38061,495971,116013,178910,79661,230649,67313,208912,61343,21737,25402,9920,16901,11817,18438,25450,24616,60962,41102
48455,12109,2740,5804,1610,1430,880,3345,1108,3114,1077,231,317,57,205,174,294,298,343,731,549,6305,1623,934,740,3416,1120,3050,1067,366,411,219,324,147,280,871,613,1084,782
48457,18176,4862,9893,2827,3525,1475,4445,1578,3797,1398,648,530,245,383,403,423,360,448,1563,1058,8283,2588,1609,1098,4238,1579,3812,1415,426,552,216,422,210,358,1353,932,1083,886
48459,32918,8354,16008,4718,4191,2637,8937,3008,8279,2860,658,884,290,617,368,637,765,876,2115,1669,16910,4870,3701,2486,8891,3020,8160,2825,731,919,402,652,329,651,1838,1341,2480,1809
48461,2898,536,1523,341,430,203,803,193,721,187,82,77,12,31,70,75,56,54,234,134,1375,283,284,149,782,184,698,180,84,72,50,62,34,45,147,104,162,91
48463,20919,6761,10148,3853,3912,2462,4886,2285,4279,2023,607,853,119,357,488,753,306,523,1044,1029,10771,3873,3296,2336,5076,2180,4277,2029,799,802,567,660,232,419,1063,920,1336,1175
48465,37348,10439,19088,6223,6637,3912,10654,3942,9398,3604,1256,1336,250,665,1006,1180,491,871,1306,1370,18260,5715,4737,3024,10056,3758,8604,3325,1452,1521,576,943,876,1219,1842,1713,1625,1538
48467,44761,11110,21747,6135,5319,3185,13082,4065,12262,3900,820,1006,398,761,422,743,876,1016,2470,1998,23014,6123,4201,2889,13224,4092,12007,3795,1217,1402,426,812,791,1088,2848,1976,2741,1940
48469,72525,18267,35130,10889,11804,7242,18971,6635,17171,6121,1800,2254,522,1222,1278,1975,956,1496,3399,2972,37395,10621,9906,6236,18741,6674,16194,5816,2547,2747,1123,1747,1424,2044,4061,3190,4687,3669
48471,63152,15642,37598,11478,16091,7709,14614,5369,10622,4460,3992,1903,457,803,3535,1728,926,1008,5967,2762,25554,7387,9928,5034,11003,4100,10359,3928,644,1032,332,773,312,774,2134,1864,2489,2057
48473,41234,8681,20342,5588,8465,4195,9684,2729,8416,2480,1268,1152,529,702,739,786,532,698,1661,1340,20892,5079,8214,3520,9547,2593,8743,2481,804,777,348,510,456,616,1445,1222,1686,1267
48475,9003,2207,4522,1282,1385,753,2535,865,2259,805,276,331,38,149,238,314,205,243,397,333,4481,1313,1142,674,2470,863,2281,808,189,233,57,166,132,207,364,298,505,374
48477,28834,8095,13914,4665,4492,2805,7608,3003,6848,2655,760,940,271,608,489,711,408,686,1406,1419,14920,4731,4309,2771,7243,2795,6789,2660,454,751,250,565,204,538,1796,1431,1572,1514
48479,197589,43377,95303,24883,37716,16618,49684,15015,43001,13494,6683,6304,2060,3445,4623,5110,1781,3039,6122,5988,102286,25305,35820,16518,48170,14300,39644,12467,8526,7078,4518,4857,4008,4685,7878,6305,10418,7323
48481,32643,9145,15937,5514,5661,3566,8296,3291,7700,3149,596,903,152,602,444,806,574,889,1406,1364,16706,5167,4273,2844,8692,3306,7722,3109,970,1167,466,830,504,817,1811,1466,1930,1641
48483,4168,681,2057,389,456,212,1256,310,1159,291,97,114,38,73,59,88,73,98,272,179,2111,381,401,206,1209,300,1098,278,111,116,66,88,45,75,237,116,264,146
48485,106647,24206,55440,15167,22265,9931,25404,8776,21888,7829,3516,3206,759,1988,2757,2761,1466,2297,6305,4935,51207,13762,13880,8318,24866,8809,22080,7892,2786,3454,1208,2273,1578,2725,5476,4130,6985,4928
48487,10471,2518,5118,1494,1608,863,2620,1005,2402,969,218,287,60,170,158,262,210,293,680,534,5353,1413,1323,781,2717,1002,2590,963,127,239,88,216,39,170,590,483,723,549
48489,17233,5059,9469,3223,4261,2241,4414,1741,3459,1500,955,751,370,486,585,547,104,244,690,621,7764,2446,2433,1431,3469,1418,2924,1202,545,618,260,388,285,462,759,601,1103,850
48491,429643,89934,208960,52856,67780,35759,118909,31268,110119,28172,8790,10940,2890,6086,5900,8691,4030,6328,18241,14948,220683,53130,58870,31622,117512,30674,108237,27637,9275,11144,4371,7394,4904,7582,14463,12424,29838,19985
48493,39511,8918,19761,5251,5537,3151,11845,3159,10785,2886,1060,1138,291,613,769,998,525,707,1854,1536,19750,5021,4746,2937,11583,3020,10683,2831,900,1059,332,618,568,845,1537,1318,1884,1511
48495,5910,1891,3026,1086,1047,700,1665,623,1502,582,163,231,30,127,133,208,68,152,246,235,2884,1022,550,499,1828,721,1628,645,200,219,87,177,113,188,163,163,343,313
48497,52790,11423,26505,6563,7191,3723,15569,4242,14421,3989,1148,1297,339,684,809,1060,773,914,2972,2128,26285,6558,5606,3174,15091,4118,13824,3821,1267,1391,718,1037,549,873,2671,1969,2917,2083
48499,37312,8325,18370,4750,4889,2906,10489,2970,9642,2772,847,908,253,561,594,774,702,816,2290,1696,18942,4875,3693,2287,10001,2945,9124,2695,877,1136,424,738,453,800,2702,1846,2546,1849
48501,6234,1569,3175,1001,871,659,2008,711,1882,677,126,224,72,148,54,160,120,198,176,227,3059,859,561,437,1911,621,1855,607,56,129,29,111,27,100,280,283,307,309
48503,14402,3844,7023,2273,1574,1176,4276,1605,3977,1521,299,444,95,284,204,395,326,454,847,786,7379,2217,1517,1147,4415,1641,4148,1614,267,451,64,267,203,412,879,768,568,603
48505,10236,3242,4933,1888,2003,1240,2225,1050,2111,1024,114,221,83,210,31,142,210,258,495,503,5303,1790,1620,1141,2610,1198,2121,1062,489,557,227,322,262,367,643,541,430,496
48507,9044,2999,4646,1856,2001,1209,2058,1093,1763,994,295,352,157,299,138,197,92,217,495,635,4398,1542,1577,906,1757,867,1523,823,234,276,170,234,64,166,570,464,494,511
49001,4767,1114,2463,616,567,307,1505,460,1428,445,77,143,30,94,47,111,102,140,289,240,2304,591,388,265,1601,463,1499,458,102,116,61,101,41,90,151,131,164,163
49003,39548,7713,20029,4620,5406,2979,12606,3084,11994,2974,612,798,203,531,409,689,494,666,1523,1175,19519,4226,3821,2161,12757,3008,12096,2900,661,841,260,567,401,704,1265,1020,1676,1328
49005,92293,17083,45965,11053,16622,8363,26498,5860,25412,5617,1086,1561,385,1153,701,1247,464,1091,2381,2137,46328,9813,14519,7126,26415,5920,25158,5672,1257,1650,479,1108,778,1359,2103,1869,3291,2415
49007,15920,2938,7840,1718,1913,1044,4531,1160,4230,1107,301,353,140,243,161,254,244,290,1152,740,8080,1679,1717,961,4370,1102,4092,1052,278,311,159,243,119,215,802,549,1191,705
49009,499,129,308,95,88,58,176,81,107,37,69,77,5,7,64,77,3,4,41,46,191,61,52,44,134,38,122,35,12,12,12,12,0,11,1,3,4,7
49011,251591,43147,125514,26229,37136,17688,78097,16073,74444,15560,3653,4540,1313,2958,2340,3544,1735,3034,8546,7204,126077,24461,30310,15024,77066,16135,72823,15143,4243,5064,1668,3217,2575,3747,6071,5538,12630,8763
49013,14398,1442,7342,933,1830,610,4762,673,4548,643,214,210,82,141,132,163,128,128,622,316,7056,779,1383,468,4462,620,4263,609,199,182,91,143,108,142,570,281,641,289
49015,7630,1317,3808,764,795,402,2619,570,2533,571,86,115,42,102,44,88,164,168,230,183,3822,704,719,393,2439,533,2386,529,53,94,31,102,22,89,347,216,317,201
49017,4031,721,2049,415,516,272,1256,302,1147,283,109,99,6,45,103,100,36,59,241,149,1982,419,418,253,1160,279,1028,263,132,119,64,90,68,79,182,107,222,138
49019,7898,2184,4046,1355,1168,803,2412,899,2133,894,279,325,108,195,171,233,95,165,371,360,3852,1205,641,595,2265,972,2050,908,215,343,85,218,130,214,339,385,607,458
49021,38886,8864,19240,5264,6271,3741,11091,3011,10471,2867,620,807,190,446,430,687,302,511,1576,1480,19646,5277,5553,3480,11527,3059,10667,2858,860,1097,307,627,553,819,915,939,1651,1358
49023,8067,1418,4027,810,1122,470,2443,533,2310,512,133,163,25,85,108,146,137,125,325,230,4040,815,956,431,2467,550,2288,520,179,188,54,94,125,160,344,245,273,217
49025,6101,1584,3049,1042,849,603,1555,593,1454,563,101,184,57,140,44,109,57,101,588,431,3052,848,779,503,1428,532,1319,504,109,176,44,117,65,121,351,290,494,412
49027,9512,1832,4867,1079,1191,619,3204,764,3097,752,107,179,11,104,96,187,113,166,359,295,4645,1011,859,486,3054,712,2951,705,103,185,22,124,81,168,402,302,330,263
49029,8234,1064,4122,570,939,299,2819,456,2753,449,66,94,3,50,63,92,59,81,305,208,4112,598,886,373,2875,434,2806,432,69,88,39,76,30,51,127,114,224,160
49031,1500,254,817,179,206,82,455,109,353,73,102,89,0,22,102,89,42,35,114,88,683,145,125,81,432,91,391,76,41,62,0,22,41,62,112,43,14,13
49033,1813,364,826,223,236,103,524,157,490,143,34,54,24,55,10,16,23,44,43,37,987,199,285,149,599,145,556,142,43,47,42,47,1,15,44,29,59,48
49035,872748,172409,435868,106107,154994,74574,233862,62216,215601,57588,18261,20801,6534,12637,11727,16084,7904,12586,39108,31369,436880,99589,127336,63982,232821,61061,212271,56448,20550,22086,8030,13484,12520,16646,25729,22786,50994,35035
49037,11409,1978,5647,1161,2396,781,2672,736,2390,698,282,254,84,138,198,224,177,236,402,373,5762,1162,2136,759,2635,729,2347,678,288,287,125,166,163,218,491,335,500,370
49039,23717,4427,12611,2699,4486,1710,6662,1652,5848,1497,814,518,174,291,640,484,248,290,1215,736,11106,2399,2900,1356,6744,1669,6397,1609,347,387,77,209,270,355,758,624,704,532
49041,16071,2723,8171,1635,2082,911,5024,1085,4803,1061,221,281,87,190,134,222,239,270,826,551,7900,1477,1546,831,4905,1049,4593,1019,312,320,73,205,239,307,640,443,809,585
49043,32824,6843,16621,4083,4972,2648,10131,2599,9603,2435,528,819,149,523,379,690,201,466,1317,1238,16203,3892,3931,2264,10014,2562,9373,2363,641,848,245,561,396,669,711,829,1547,1221
49045,48883,9594,24402,5745,7085,3691,14451,3621,13754,3521,697,855,379,710,318,554,471,708,2395,1822,24481,5195,6029,2977,14299,3661,13531,3573,768,968,423,741,345,642,1349,1212,2804,1782
49047,25886,5548,13076,3245,4177,2149,7182,2019,6599,1821,583,783,104,292,479,700,266,415,1451,1086,12810,3217,3405,1935,6680,1814,6324,1727,356,542,177,367,179,408,956,805,1769,1125
49049,433085,81347,217118,51094,75510,37449,129169,27654,122238,26059,6931,8469,1724,4984,5207,7279,2425,4976,10014,9756,215967,46853,65061,32217,128039,27060,120719,25670,7320,8441,2616,5533,4704,6758,8837,8390,14030,11423
49051,23359,3959,11798,2402,3298,1620,7595,1449,7172,1410,423,418,105,184,318,356,151,219,754,609,11561,2222,2831,1400,7285,1456,6994,1416,291,311,70,158,221,264,533,405,912,628
49053,129334,22664,63103,13652,17407,9086,39089,8357,36975,7874,2114,2407,650,1285,1464,1929,1367,1726,5240,4078,66231,12942,13675,7237,39217,8271,36444,7887,2773,2761,1167,1625,1606,1982,5148,3441,8191,5255
49055,2105,255,1090,150,270,102,656,118,613,117,43,38,4,16,39,36,61,48,103,63,1015,155,137,73,604,136,573,137,31,31,10,15,21,27,110,60,164,93
49057,191562,37282,95841,22695,31207,15594,53107,14004,49601,13210,3506,4181,1348,2718,2158,3307,1905,2975,9622,7233,95721,21715,24296,13112,53069,13833,49021,13036,4048,4688,1837,3110,2211,3463,5938,5102,12418,8356
50001,31755,4273,15594,2634,5544,1846,8052,1663,7662,1588,390,439,150,296,240,360,443,470,1555,883,16161,2508,4834,1631,8010,1648,7701,1587,309,392,94,300,215,345,1293,817,2024,1050
50003,30214,6717,14467,4014,4836,2526,7367,2319,6761,2184,606,745,263,507,343,558,714,853,1550,1152,15747,3822,4246,2320,7370,2419,6934,2226,436,671,197,487,239,517,1869,1350,2262,1357
50005,25426,4135,12658,2658,4164,1821,6397,1632,6005,1574,392,507,220,370,172,336,445,478,1652,1077,12768,2348,2935,1435,6825,1710,6366,1650,459,543,221,392,238,386,1164,758,1844,968
50007,138808,24585,67490,15979,28608,12383,31769,8456,30147,8030,1622,2167,529,1322,1093,1762,1483,2149,5630,4733,71318,14563,26183,10597,31549,8403,29973,7939,1576,2208,554,1366,1022,1797,5085,4087,8501,5415
50009,5322,631,2666,365,706,222,1489,262,1409,251,80,70,18,47,62,71,116,78,355,176,2656,357,546,179,1486,248,1334,231,152,108,81,73,71,76,305,146,319,153
50011,40150,8316,19864,5038,6326,3262,10690,2996,9913,2809,777,940,399,649,378,636,514,640,2334,1713,20286,4791,5382,3010,10551,2918,10010,2813,541,724,152,438,389,617,1669,1233,2684,1709
50013,6028,930,2999,541,876,357,1785,356,1718,354,67,82,41,86,26,68,59,80,279,168,3029,514,692,294,1793,354,1760,348,33,67,23,80,10,59,213,130,331,187
50015,21011,3117,10519,1932,3477,1337,5344,1374,5141,1345,203,291,39,139,164,245,259,370,1439,911,10492,1748,2810,1156,5531,1440,5061,1324,470,521,163,259,307,404,622,463,1529,799
50017,24567,3438,12126,1999,3530,1313,6640,1373,6298,1339,342,368,89,232,253,326,256,276,1700,928,12441,2019,2800,1197,6531,1328,6186,1292,345,336,182,256,163,269,1007,613,2103,948
50019,22667,3364,11320,2049,3430,1284,6054,1372,5665,1326,389,408,139,267,250,328,363,376,1473,773,11347,1973,2481,1098,6111,1332,5854,1306,257,315,71,227,186,293,1191,708,1564,769
50021,50362,9123,24635,5570,8167,3795,12454,3400,11803,3239,651,946,229,739,422,764,747,903,3267,2205,25727,5429,6717,3442,13193,3575,12437,3479,756,964,251,636,505,843,2597,1691,3220,2099
50023,49290,9251,24211,5668,8245,3852,12188,3255,11582,3172,606,873,196,622,410,707,580,766,3198,2172,25079,5448,6865,3500,12144,3331,11451,3172,693,940,315,680,378,710,2210,1698,3860,2311
50025,36502,7112,17634,4258,6114,2897,8598,2586,8056,2495,542,684,273,560,269,532,560,769,2362,1628,18868,4338,4821,2583,8783,2697,8116,2563,667,882,215,544,452,733,1781,1320,3483,2035
50027,47087,9256,22882,5420,6417,3356,12868,3717,12112,3577,756,996,191,593,565,881,856,1037,2741,2057,24205,5549,5635,3201,12732,3696,12185,3596,547,840,239,662,308,650,2196,1708,3642,2316
51001,26925,7427,12930,4523,4183,3076,7089,2759,6326,2451,763,1073,370,671,393,814,596,757,1062,1068,13995,4337,3291,2561,7541,2825,6613,2621,928,1012,658,883,270,588,1774,1292,1389,1232
51003,89500,18049,42248,10513,14649,7125,23287,6556,21511,5956,1776,2164,734,1427,1042,1614,1364,1830,2948,2535,47252,10899,14549,6872,23361,6287,21402,5965,1959,2154,1149,1668,810,1371,4223,3212,5119,3529
51005,12886,2551,6137,1481,1643,894,3553,1016,3319,971,234,323,119,255,115,233,294,323,647,525,6749,1545,1438,834,3412,978,3267,949,145,250,91,227,54,195,1021,611,878,612
51007,10672,2793,5290,1708,1356,1098,3178,1157,2935,1098,243,375,196,339,47,146,141,251,615,552,5382,1569,1142,785,2891,1039,2752,1032,139,215,71,170,68,165,872,611,477,420
51009,26541,5445,12679,3278,4082,2177,6824,1975,6326,1828,498,655,357,560,141,352,476,496,1297,1068,13862,3110,3360,1676,7106,2060,6410,1881,696,765,428,594,268,467,1627,1129,1769,1217
51011,12983,2866,6248,1609,1527,865,4061,1127,3709,1070,352,387,229,322,123,212,140,233,520,485,6735,1615,1564,853,3810,1012,3542,1001,268,289,102,194,166,240,617,476,744,589
51013,197426,39520,98323,26067,44689,19871,46536,15880,41521,14309,5015,6046,1198,3209,3817,5240,1365,3175,5733,6152,99103,24064,41486,18118,43765,14707,39846,13685,3919,5264,1202,3167,2717,4348,4856,5287,8996,7313
51015,63451,13703,32367,8245,9051,4851,18758,5543,17113,5178,1645,1598,657,1141,988,1231,1169,1564,3389,2639,31084,7501,6144,3878,18283,5335,16891,5093,1392,1608,766,1273,626,1107,3480,2736,3177,2431
51017,3734,1342,1837,699,549,418,1023,502,844,459,179,227,48,85,131,181,92,152,173,170,1897,803,586,508,948,498,880,478,68,131,0,60,68,131,183,223,180,223
51019,65653,12011,32063,6936,7826,4122,19965,4815,19018,4656,947,1239,384,864,563,983,1079,1411,3193,2430,33590,7049,6811,4015,20073,4852,18809,4613,1264,1550,633,1108,631,1094,3293,2351,3413,2596
51021,5546,1191,3072,798,928,446,1642,526,1307,457,335,202,116,128,219,153,134,152,368,235,2474,618,353,251,1533,490,1454,472,79,106,21,73,58,106,273,188,315,236
51023,28240,5237,13826,3155,3370,1898,8733,2085,8398,2060,335,469,155,379,180,360,541,584,1182,1014,14414,2968,2851,1630,8828,2129,8286,2041,542,638,264,472,278,472,1320,922,1415,979
51025,14279,3289,7718,2132,3522,1438,3002,1243,2320,1045,682,560,339,386,343,377,204,308,990,655,6561,1801,2158,1092,2491,1067,2002,927,489,501,293,349,196,335,959,700,953,747
51027,18602,5151,9317,3167,2835,1900,4858,1978,4319,1765,539,687,300,527,239,479,455,583,1169,1024,9285,2844,1894,1434,4850,1822,4173,1685,677,774,383,563,294,535,1209,1051,1332,1118
51029,14496,2671,8042,1649,2839,1041,3601,1011,2794,889,807,469,362,369,445,289,360,386,1242,576,6454,1485,1693,835,3174,974,2777,891,397,410,197,262,200,292,906,597,681,477
51031,46285,9274,22206,5465,6113,3208,12917,3799,11938,3625,979,1183,546,866,433,817,946,1124,2230,1926,24079,5621,5728,3280,12265,3625,11304,3449,961,1177,490,835,471,846,2979,2102,3107,2161
51033,24385,5397,12069,3557,4233,2175,5922,2022,5162,1756,760,738,247,386,513,561,367,461,1547,1163,12316,2827,3129,1639,6163,1863,5611,1812,552,570,311,457,241,367,1154,808,1870,1259
51035,25248,6329,12547,3737,3205,2119,7255,2450,6591,2301,664,793,342,544,322,581,610,739,1477,1293,12701,3689,2304,1861,7067,2329,6417,2228,650,760,394,578,256,498,1720,1187,1610,1475
51036,6142,683,2973,410,1037,297,1461,258,1352,248,109,89,55,65,54,70,118,77,357,153,3169,416,852,275,1559,268,1368,243,191,140,117,108,74,82,457,186,301,144
51037,9918,2198,4862,1321,1729,879,2234,730,2064,689,170,228,124,204,46,140,185,239,714,521,5056,1266,1365,727,2368,767,2046,687,322,304,270,280,52,148,690,469,633,487
51041,276582,47736,131134,28353,41837,19518,75450,17453,70550,16485,4900,5781,2398,3996,2502,4109,3581,4488,10266,7891,145448,28947,39800,19368,76981,17454,70810,16363,6171,6443,3469,4729,2702,4120,10804,7904,17863,10786
51043,12107,2501,6022,1496,1782,970,3476,1046,3244,1001,232,284,54,158,178,258,162,260,602,513,6085,1437,1155,772,3506,1026,3198,981,308,348,165,246,143,233,768,617,656,513
51045,4326,885,2000,467,483,268,1204,368,1171,367,33,79,33,79,0,36,48,77,265,241,2326,611,586,423,1242,389,1217,390,25,49,25,49,0,36,191,163,307,215
51047,40609,6588,20322,3969,6586,2829,11355,2522,10380,2300,975,871,525,620,450,549,565,640,1816,1156,20287,3774,5545,2525,11246,2496,10227,2294,1019,983,703,790,316,470,1465,1024,2031,1266
51049,8277,2088,3956,1232,1168,763,2127,790,1958,738,169,235,158,230,11,90,178,233,483,441,4321,1204,1239,695,2290,845,2072,798,218,280,129,217,89,173,430,343,362,340
51051,12402,3278,6255,1968,1777,1133,3271,1274,2967,1169,304,397,85,246,219,347,306,354,901,701,6147,1903,1134,884,3393,1214,2895,1127,498,525,435,498,63,204,892,637,728,628
51053,23666,6050,11433,3508,4013,2244,5654,2091,5094,1910,560,761,366,603,194,408,456,612,1310,1071,12233,3543,3290,2087,5818,2138,5263,1950,555,736,230,449,325,558,1454,1203,1671,1315
51057,9107,2191,4150,1262,1226,844,2195,797,2088,770,107,200,48,130,59,164,144,189,585,471,4957,1293,1642,873,2287,814,2168,787,119,193,65,142,54,155,632,436,396,320
51059,921218,166603,453041,102628,153784,72084,266556,63063,243150,56360,23406,25011,5728,12258,17678,21441,7504,12590,25197,23321,468177,96928,135582,64088,259421,59205,235145,53984,24276,24049,8190,13866,16086,19456,29146,24050,44028,30739
51061,56598,9000,27753,5402,8105,3596,16509,3443,15471,3297,1038,1076,430,696,608,821,712,814,2427,1846,28845,5210,6853,3126,16269,3467,15043,3249,1226,1227,599,830,627,868,2375,1677,3348,2078
51063,13299,2607,6613,1606,1574,910,3970,1022,3798,963,172,241,75,173,97,194,257,322,812,594,6686,1438,1160,659,4042,1103,3729,991,313,380,139,209,174,274,700,441,784,532
51065,22258,4014,9908,2220,2717,1531,6022,1402,5769,1377,253,331,95,220,158,280,208,307,961,782,12350,2509,3009,1571,6691,1511,6078,1431,613,473,300,328,313,332,1001,745,1649,839
51067,47506,10276,23087,6057,5807,3506,13843,4190,13208,4062,635,956,255,623,380,737,937,1132,2500,2026,24419,5775,5264,3255,13443,3888,12474,3809,969,1102,601,890,368,705,2957,2165,2755,2150
51069,70022,13207,34623,7900,10128,5089,20482,4988,19412,4843,1070,1242,502,913,568,897,858,1220,3155,2492,35399,7530,7816,4448,20455,4997,19138,4756,1317,1481,494,902,823,1170,3147,2288,3981,2758
51071,13950,2972,6813,1761,1871,1077,3954,1151,3667,1094,287,370,98,219,189,319,345,384,643,498,7137,1740,1558,916,3646,1096,3269,1002,377,469,258,403,119,258,950,622,983,673
51073,31305,6619,15260,3743,4081,2159,9315,2554,8833,2482,482,614,204,410,278,485,420,568,1444,1112,16045,3874,3115,2023,9314,2566,8621,2426,693,793,325,579,368,565,1683,1228,1933,1469
51075,19702,3802,9670,2434,2695,1537,5847,1405,5447,1337,400,441,206,326,194,271,405,443,723,658,10032,2142,1947,1108,6084,1515,5638,1397,446,434,214,275,232,317,991,679,1010,740
51077,13576,3726,6942,2415,2101,1377,3729,1232,3394,1157,335,416,80,239,255,364,263,295,849,697,6634,1875,1140,831,3766,1309,3365,1099,401,566,304,497,97,263,860,547,868,650
51079,15707,2941,7675,1660,2184,1065,4745,1189,4415,1182,330,341,110,200,220,284,172,258,574,450,8032,1744,1882,1066,4480,1154,4044,1093,436,440,268,347,168,245,672,549,998,650
51081,9988,1438,6444,1010,3092,661,2189,626,1515,508,674,247,227,156,447,188,228,196,935,473,3544,721,843,481,1778,529,1625,521,153,157,116,148,37,91,589,311,334,283
51083,28792,7605,13629,4577,4426,2715,7291,2841,6318,2489,973,1187,585,872,388,733,710,928,1202,1211,15163,4434,3919,2574,7222,2716,6570,2594,652,852,349,610,303,590,2327,1606,1695,1446
51085,86743,13113,41935,8083,11696,5335,25759,5105,24481,4947,1278,1549,623,1163,655,1075,957,1235,3523,2736,44808,7800,10378,4991,25833,5133,24466,4945,1367,1622,732,1172,635,1143,3775,2703,4822,2947
51087,265460,51109,123510,31746,44465,22756,65551,18316,59860,16689,5691,6880,2222,4061,3469,5121,2964,4203,10530,9093,141950,30995,44550,21308,65005,17879,57532,16009,7473,7699,4162,5515,3311,4840,11987,8743,20408,12292
51089,43125,10113,20519,5878,5407,3341,11116,3824,9765,3425,1351,1511,631,955,720,1128,1195,1386,2801,2198,22606,6181,5093,3420,11141,3783,9811,3457,1330,1519,839,1161,491,865,3189,2212,3183,2225
51091,1978,359,981,204,160,115,676,172,632,165,44,44,5,31,39,41,54,57,91,72,997,223,128,96,673,174,650,173,23,38,0,36,23,38,108,72,88,80
51093,30357,5586,14745,3379,3911,2111,8970,2267,8372,2161,598,723,302,517,296,481,457,585,1407,1132,15612,3184,3458,1984,8907,2189,8247,2091,660,699,342,494,318,519,1590,1085,1657,1133
51095,62639,9542,29837,5767,8142,3771,18854,3757,17667,3519,1187,1177,408,652,779,979,788,948,2053,1628,32802,5888,7798,3736,18664,3611,17230,3437,1434,1409,599,820,835,1028,2714,1706,3626,2299
51097,5937,1234,2955,748,734,405,1641,554,1433,519,208,249,134,194,74,113,189,195,391,318,2982,705,762,392,1362,482,1334,479,28,82,13,70,15,72,463,270,395,300
51099,20705,2756,10370,1686,3117,1264,6260,1180,5813,1166,447,449,267,360,180,265,107,158,886,622,10335,1647,2398,992,6315,1302,5746,1195,569,537,317,367,252,326,686,449,936,625
51101,13551,2880,6538,1590,1868,993,4005,1125,3858,1111,147,242,76,197,71,154,151,225,514,455,7013,1686,1777,1058,3910,1064,3711,1033,199,263,67,156,132,218,587,427,739,543
51103,9363,2279,4316,1271,935,684,2724,911,2562,867,162,245,30,169,132,225,211,251,446,443,5047,1413,974,744,2761,921,2614,887,147,246,54,150,93,226,764,559,548,453
51105,20335,5875,10628,3368,3288,1912,5141,2126,4465,1892,676,754,355,526,321,558,497,639,1702,1285,9707,3332,1998,1615,4978,1994,4449,1889,529,683,328,528,201,456,1492,1142,1239,1130
51107,301119,48584,148048,28835,42173,18837,96510,19229,90361,17873,6149,6371,2021,3577,4128,5067,1873,3255,7492,6401,153071,28495,37558,18056,93678,18095,87558,17140,6120,6181,2382,3768,3738,4651,8195,6609,13640,9171
51109,29864,5566,14628,3170,4145,2147,8575,2059,8131,1999,444,557,169,309,275,445,539,575,1369,989,15236,3247,3482,1826,8732,2187,8078,2034,654,752,479,627,175,336,1379,1022,1643,1087
51111,10524,2349,5434,1315,1844,791,2784,797,2351,727,433,330,179,224,254,207,158,199,648,392,5090,1361,1458,843,2475,795,2245,723,230,232,118,165,112,186,574,411,583,411
51113,10919,2410,5330,1443,1418,855,3382,985,2943,922,439,476,137,221,302,358,187,258,343,349,5589,1377,1353,810,3180,971,2922,947,258,303,59,128,199,278,513,448,543,388
51115,7930,2487,3850,1479,1102,866,2168,956,2101,903,67,201,45,190,22,107,213,292,367,421,4080,1349,795,562,2334,1034,2278,1034,56,149,17,113,39,132,646,614,305,363
51117,25937,6232,12473,3550,4146,2173,6450,2168,5735,2042,715,817,433,598,282,550,591,802,1286,1125,13464,3838,3371,2272,6203,2227,5445,1978,758,889,385,581,373,647,2191,1440,1699,1280
51119,9222,2256,4525,1368,1146,761,2550,914,2273,847,277,329,119,236,158,254,209,254,620,514,4697,1314,937,689,2433,876,2146,798,287,328,148,246,139,243,796,568,531,436
51121,85407,18538,44197,12673,22842,10092,17892,5817,16630,5449,1262,1822,451,1147,811,1449,732,1247,2731,2851,41210,11806,17693,9093,16477,5306,14949,4865,1528,2035,565,1171,963,1658,2903,2581,4137,3259
51125,12497,3076,5993,1729,1457,916,3858,1307,3555,1239,303,398,164,308,139,240,199,296,479,472,6504,1719,1228,858,3757,1298,3448,1273,309,400,159,305,150,259,773,639,746,636
51127,17890,3321,8962,1917,2537,1286,5540,1287,5103,1209,437,459,246,321,191,297,349,408,536,464,8928,1912,1737,1122,5600,1345,5173,1300,427,438,309,376,118,207,784,609,807,665
51131,9862,2333,4656,1285,1481,818,2482,866,2298,824,184,241,135,210,49,163,210,238,483,404,5206,1433,1358,850,2407,835,2119,763,288,306,185,249,103,197,813,551,628,445
51133,10590,3157,5070,1683,841,771,3186,1225,3046,1215,140,254,68,210,72,199,395,440,648,611,5520,1804,1054,874,3087,1188,2945,1171,142,258,88,230,54,186,748,654,631,614
51135,12939,3510,7167,2224,3032,1498,2925,1333,2379,1202,546,460,169,283,377,401,323,437,887,703,5772,1891,1356,957,2778,1293,2285,1177,493,589,316,485,177,307,879,678,759,624
51137,29426,6042,14309,3678,3995,2188,8122,2276,7486,2147,636,672,408,540,228,373,440,540,1752,1305,15117,3561,4045,2284,8136,2282,7603,2201,533,676,400,595,133,297,1355,941,1581,1251
51139,19853,5171,9757,2949,3003,1879,5301,1829,4850,1721,451,610,246,446,205,408,363,510,1090,908,10096,2953,2137,1480,5617,2005,5050,1807,567,724,250,443,317,530,1174,890,1168,932
51141,15190,3631,7495,2212,1610,1058,4407,1584,3993,1434,414,552,294,474,120,282,431,505,1047,830,7695,2028,1123,913,4554,1537,4116,1475,438,469,323,396,115,278,1121,820,897,738
51143,51944,9743,25493,5839,6754,3434,15007,4121,13705,3881,1302,1207,703,975,599,791,978,1063,2754,2031,26451,5683,5904,3253,14386,3944,13203,3765,1183,1261,890,1127,293,641,3179,2028,2982,2078
51145,24629,4092,13182,2441,4218,1508,7487,1700,7050,1638,437,388,200,298,237,267,311,366,1166,739,11447,2359,1984,1184,7499,1716,7195,1668,304,405,188,325,116,263,842,727,1122,937
51147,19899,4628,9944,2899,5457,2097,3491,1398,3047,1203,444,555,167,289,277,461,273,360,723,583,9955,2903,4425,2083,3554,1357,3151,1238,403,462,317,441,86,224,1178,794,798,668
51149,31208,5882,17135,3921,6431,2778,8561,2381,7160,1883,1401,1149,620,789,781,693,488,596,1655,1035,14073,3234,3643,2034,7399,1951,6753,1767,646,692,389,526,257,447,1358,1042,1673,1223
51153,356482,72438,176490,42462,59130,27630,102103,25588,91351,22729,10752,10686,3755,5961,6997,8339,2683,4631,12574,10786,179992,41124,52604,25493,99543,24203,88657,21728,10886,10161,4789,6443,6097,7293,10239,9028,17606,12394
51155,29232,6924,14633,4223,3921,2375,8279,2946,7251,2590,1028,1163,542,808,486,787,523,736,1910,1514,14599,3874,2919,1875,8182,2851,7600,2697,582,808,343,647,239,538,1729,1390,1769,1486
51157,6309,1020,3184,656,904,428,1723,438,1543,393,180,202,58,96,122,173,203,185,354,207,3125,598,674,367,1680,423,1571,413,109,135,76,102,33,84,361,230,410,268
51159,7533,1525,4313,944,1495,567,2208,671,1656,606,552,235,183,163,369,189,141,170,469,235,3220,808,449,369,2027,688,1929,679,98,136,41,93,57,114,351,248,393,262
51161,78498,14115,37222,8196,9779,5131,22423,5654,21147,5460,1276,1487,550,1038,726,1134,1187,1528,3833,2985,41276,8425,9345,4988,22157,5582,20751,5336,1406,1730,786,1316,620,1120,4317,2751,5457,3379
51163,19374,4998,9507,2825,2486,1669,5586,1954,5304,1911,282,452,88,281,194,385,278,436,1157,971,9867,3011,1980,1443,5292,1950,4857,1805,435,556,209,400,226,405,1199,970,1396,1228
51165,65731,10520,31935,6254,9134,4148,19078,4138,18241,4072,837,1011,382,772,455,809,1166,1231,2557,1981,33796,6095,8242,3589,18840,4144,17943,3993,897,1131,606,966,291,709,3590,2166,3124,1990
51167,22940,6897,11239,4071,3087,2397,6331,2549,6014,2479,317,580,152,441,165,477,482,717,1339,1304,11701,3803,2156,1636,6375,2530,5702,2342,673,932,486,784,187,487,1794,1564,1376,1227
51169,18640,4083,9363,2370,2432,1395,5050,1562,4756,1488,294,414,162,337,132,303,414,484,1467,1009,9277,2352,1690,1088,5124,1584,4651,1443,473,515,365,467,108,316,1377,995,1086,854
51171,35691,6199,17374,3753,4882,2414,9875,2434,9135,2264,740,812,348,576,392,577,662,747,1955,1450,18317,3718,3777,2063,9706,2343,8870,2230,836,894,368,582,468,652,2228,1467,2606,1586
51173,25872,5672,12586,3338,3367,1908,7092,2161,6361,2043,731,768,415,609,316,516,440,560,1687,1173,13286,3254,2401,1539,7140,2178,6368,2019,772,772,540,652,232,498,1809,1140,1936,1372
51175,15052,2651,7843,1661,2115,963,4184,1084,3718,1016,466,338,300,300,166,152,415,355,1129,536,7209,1424,1800,766,3671,926,3315,844,356,294,209,221,147,209,850,488,888,557
51177,105751,17867,51494,10802,16252,7309,29861,6512,27621,6102,2240,2367,1056,1697,1184,1631,1121,1609,4260,3243,54257,10527,14745,6841,29236,6309,26525,5927,2711,2588,1490,1922,1221,1628,4048,2922,6228,3809
51179,115531,18197,58091,11124,19049,8074,34116,6871,31971,6434,2145,2240,818,1352,1327,1761,1003,1373,3923,3030,57440,10661,14608,6567,33595,6697,30984,6227,2611,2543,1415,1806,1196,1619,3345,2643,5892,3869
51181,5611,1149,2684,652,656,376,1682,492,1547,462,135,163,106,148,29,72,53,103,293,245,2927,716,796,499,1502,466,1419,447,83,115,53,99,30,91,328,231,301,247
51183,9906,1939,6037,1379,3067,983,2226,779,1668,624,558,389,157,189,401,335,133,176,611,380,3869,924,1098,549,1897,616,1732,579,165,202,128,182,37,138,435,307,439,324
51185,35030,8565,17346,4977,5038,2871,9578,3368,8673,3145,905,1020,509,799,396,704,780,1008,1950,1576,17684,5094,3254,2274,9474,3339,8452,3040,1022,1309,744,1131,278,670,2787,2014,2169,1862
51187,32285,6578,16074,3770,5284,2398,8247,2429,7433,2254,814,907,258,494,556,749,532,679,2011,1527,16211,3943,3869,2129,8735,2545,7608,2314,1127,1066,597,743,530,709,1412,1078,2195,1503
51191,46159,8507,22500,4942,6136,3209,12864,3364,11752,3123,1112,1180,577,813,535,824,939,995,2561,1883,23659,5119,4564,2733,12909,3290,11921,3139,988,1074,488,721,500,808,3219,2097,2967,1952
51193,14857,3740,7196,2267,1828,1313,4075,1502,3684,1407,391,532,228,406,163,314,406,484,887,741,7661,2208,1500,1094,3840,1397,3600,1359,240,362,163,329,77,240,1073,900,1248,835
51195,32387,6965,17053,4348,5859,2873,8588,2721,7582,2495,1006,953,432,654,574,697,750,829,1856,1333,15334,3847,3274,1836,8164,2595,7150,2323,1014,1113,772,951,242,471,1863,1313,2033,1519
51197,24201,6017,11772,3414,3052,1867,6799,2337,6407,2255,392,614,250,518,142,392,621,755,1300,1239,12429,3435,2637,1752,6962,2394,6314,2232,648,866,297,537,351,662,1458,1140,1372,1225
51199,54814,10357,26755,6276,7451,4233,16846,4024,15828,3795,1018,1341,400,861,618,986,747,1034,1711,1680,28059,5791,6060,3537,16858,3938,15665,3739,1193,1361,466,860,727,1051,2367,1714,2774,1924
51510,132518,25633,63024,16080,25358,11891,30758,10012,26826,8955,3932,4094,1362,2446,2570,3194,1003,2065,5905,4894,69494,16393,26850,11805,30063,9469,25631,8419,4432,4293,1577,2524,2855,3328,4256,3868,8325,5782
51520,14111,3460,6645,2056,2072,1378,3384,1261,3051,1176,333,398,125,261,208,311,203,285,986,764,7466,1948,1699,1058,3620,1257,3146,1130,474,469,281,387,193,267,992,629,1155,829
51530,5282,1564,2360,836,762,521,1257,580,1147,554,110,147,64,113,46,106,43,99,298,276,2922,936,910,539,1241,608,1177,587,64,120,61,125,3,67,300,306,471,340
51540,40789,8510,19555,5600,10778,4555,6878,2696,5852,2277,1026,1249,252,654,774,1030,463,850,1436,1559,21234,5621,10649,4381,6754,2545,5914,2327,840,1088,446,814,394,740,1186,1272,2645,2000
51550,192221,37972,93069,22448,31559,15468,51989,13985,47690,13025,4299,4742,1880,3138,2419,3366,2119,3113,7402,6086,99152,22647,26452,14275,52756,13874,47918,13037,4838,5073,2450,3474,2388,3311,8025,6107,11919,8022
51570,14073,2245,6341,1338,2113,993,3304,825,3098,804,206,238,172,226,34,145,268,256,656,450,7732,1428,2429,1037,3292,833,2946,762,346,366,201,277,145,235,972,543,1039,552
51580,4610,1243,2191,728,583,341,1280,553,1135,478,145,208,19,84,126,198,52,107,276,239,2419,679,466,288,1321,545,1153,489,168,221,104,193,64,122,361,270,271,233
51590,33544,7644,15117,4406,6234,3037,6683,2712,5700,2403,983,1121,501,786,482,787,469,686,1731,1508,18427,4717,5835,3115,7340,2831,5888,2502,1452,1369,984,1140,468,802,2553,1534,2699,1781
51595,4160,1264,1927,782,829,575,788,463,599,369,189,261,142,233,47,112,70,143,240,262,2233,781,679,540,722,418,630,402,92,143,26,88,66,137,367,265,465,369
51600,19085,3517,9321,2147,3251,1592,5560,1480,5165,1389,395,478,161,309,234,359,138,267,372,379,9764,2134,2721,1405,5631,1425,5224,1333,407,460,134,321,273,354,693,546,719,536
51610,11265,1800,5359,1035,1704,739,3229,684,2997,647,232,229,20,112,212,226,57,135,369,281,5906,1183,1782,828,2956,665,2777,620,179,211,105,163,74,151,490,405,678,416
51620,6383,1617,2746,958,899,600,1431,598,1283,563,148,188,111,157,37,92,114,159,302,320,3637,1079,1089,657,1318,626,1181,599,137,204,131,200,6,74,540,342,690,491
51630,23449,4310,10418,2526,4885,1959,4449,1395,3742,1275,707,666,322,416,385,471,166,293,918,766,13031,2930,5807,2211,4758,1537,4053,1415,705,604,268,429,437,442,620,547,1846,1231
51640,5247,1521,2409,791,433,361,1455,595,1235,554,220,248,118,204,102,149,162,172,359,335,2838,1030,559,462,1351,583,1220,547,131,190,109,181,22,104,442,370,486,371
51650,111151,26040,52954,16250,21378,11297,23896,9208,20656,8233,3240,3704,1442,2390,1798,2599,1575,2367,6105,5097,58197,15424,19432,9975,23991,9115,20884,8259,3107,3564,1510,2382,1597,2653,5804,4631,8970,5961
51660,45762,8707,21712,6004,12738,5091,7293,2457,6272,2125,1021,1130,356,626,665,862,317,553,1364,1315,24050,5168,13703,4187,6937,2271,5997,1990,940,1069,609,910,331,587,1348,991,2062,1542
51670,17576,4235,7991,2531,3075,1759,3544,1581,3100,1493,444,533,158,308,286,434,330,436,1042,864,9585,2656,3179,1562,3832,1677,3201,1532,631,681,417,489,214,395,1239,1064,1335,1024
51678,6779,1536,3978,1176,3033,996,714,380,673,376,41,98,33,101,8,69,71,127,160,200,2801,897,1385,682,765,409,655,376,110,166,8,72,102,163,241,252,410,340
51680,67531,14113,31034,8427,15803,6790,11833,3956,10754,3631,1079,1351,365,874,714,1123,1128,1379,2270,1917,36497,9266,16791,7263,12994,4346,10978,3701,2016,2023,1083,1359,933,1316,2757,1948,3955,2552
51683,31726,7398,15866,4584,5621,2958,8966,2819,8382,2718,584,727,192,438,392,620,271,508,1008,1018,15860,4052,4950,2471,8210,2573,7332,2334,878,1008,396,635,482,690,941,908,1759,1302
51685,13322,3376,7007,2061,2464,1170,3811,1373,2884,1173,927,699,321,405,606,600,63,142,669,597,6315,1847,2038,1231,3126,1089,2487,905,639,556,342,389,297,331,418,490,733,506
51690,10198,2495,4505,1453,1661,962,2032,893,1808,837,224,317,90,234,134,255,174,258,638,528,5693,1539,1803,1017,2415,1035,1994,912,421,483,225,343,196,321,805,611,670,578
51700,144244,33425,68696,19978,28591,14499,32036,11317,26532,9650,5504,5182,2207,3340,3297,3703,1294,2438,6775,5850,75548,20617,27352,14027,31756,11241,26593,9766,5163,5432,3295,4227,1868,3121,6340,5088,10100,7128
51710,202936,42426,106565,28499,54336,22115,40278,14617,32857,12540,7421,6841,2834,4346,4587,5061,2231,3450,9720,8052,96371,24580,38915,17322,37662,13506,30410,11420,7252,7145,4263,5389,2989,4220,7247,5741,12547,8627
51720,3144,771,1410,476,412,287,732,303,649,267,83,138,0,48,83,138,43,66,223,206,1734,473,271,188,841,319,708,299,133,146,113,137,20,56,156,127,466,294
51730,25638,6916,11379,4085,5927,3216,3743,1845,2906,1563,837,865,481,669,356,582,319,505,1390,1097,14259,4305,6308,3052,4029,1939,2827,1575,1202,1110,807,908,395,586,1860,1243,2062,1450
51735,9994,2147,4994,1373,1585,987,2942,765,2899,762,43,146,0,132,43,146,117,210,350,368,5000,1226,774,644,3255,916,2954,803,301,374,158,245,143,269,560,422,411,380
51740,76057,18184,36063,10952,15594,8109,14835,5759,12459,5017,2376,2636,1185,1758,1191,1844,1339,1850,4295,3539,39994,11217,13597,7742,15980,6208,13032,5302,2948,3175,1870,2431,1078,1804,4364,3082,6053,4256
51750,16133,4274,7559,2691,4772,2214,1870,870,1649,756,221,354,189,347,32,131,225,298,692,743,8574,2695,5170,2206,1844,790,1508,706,336,368,295,329,41,173,546,480,1014,755
51760,192097,44885,89974,28732,49645,22808,28378,11995,22513,9161,5865,6741,2066,3617,3799,5361,2592,3817,9359,8227,102123,29141,51591,22554,29818,12339,23309,9585,6509,6999,3659,4926,2850,4386,7819,6677,12895,9065
51770,80651,20754,37912,12634,15546,8743,15383,6632,13499,6088,1884,2332,861,1640,1023,1715,1642,2209,5341,4598,42739,12152,14666,8419,16212,6694,13814,6013,2398,2753,1349,2071,1049,1790,4683,3790,7178,4923
51775,21383,4634,9988,2639,3450,1711,4944,1673,4459,1586,485,551,136,334,349,478,224,342,1370,1041,11395,2897,3415,1770,4933,1648,4518,1576,415,541,213,427,202,358,1384,995,1663,989
51790,20560,4458,9108,2510,2722,1659,4945,1671,4471,1566,474,546,183,348,291,443,263,421,1178,919,11452,2718,3236,1577,4940,1648,4388,1542,552,617,321,510,231,399,1538,984,1738,1131
51800,71822,14906,34254,8595,10130,5711,19950,5498,18530,5264,1420,1758,857,1492,563,1230,891,1278,3283,2803,37568,8992,10427,5659,19972,5513,18062,5104,1910,2073,1019,1616,891,1443,3141,2428,4028,3091
51810,366356,75277,178421,45754,60772,31066,97516,28330,89250,26104,8266,9900,3698,6682,4568,7286,4094,6348,16039,13559,187935,43843,50751,26916,98311,28010,88303,25719,10008,11094,5015,7542,4993,7545,14177,11412,24696,16495
51820,17648,4941,8343,3016,2952,1947,4032,1864,3535,1656,497,743,219,429,278,522,405,504,954,848,9305,2901,2923,1949,4023,1840,3484,1690,539,727,280,469,259,499,981,810,1378,1052
51830,13656,2269,6158,1501,3605,1213,1877,662,1694,611,183,229,50,125,133,202,213,229,463,402,7498,1433,4671,1213,1813,635,1629,599,184,230,57,140,127,198,440,320,574,387
51840,22537,6499,10872,3918,4588,2560,4642,2178,4160,1996,482,689,195,475,287,513,398,601,1244,1289,11665,3766,3782,2311,4865,2198,4202,2024,663,810,348,575,315,533,1163,1083,1855,1504
53001,13710,3043,6939,1845,2600,1288,3641,1092,3231,922,410,468,144,276,266,377,124,209,574,475,6771,1767,1981,1060,3819,1106,3302,967,517,507,295,390,222,312,390,337,581,479
53003,18603,4298,9071,2493,2311,1344,4786,1563,4443,1472,343,472,113,322,230,418,388,491,1586,1235,9532,2486,2101,1373,4909,1613,4613,1527,296,470,178,375,118,331,908,732,1614,1136
53005,153407,35335,76234,21354,24492,14080,41932,13262,39166,12504,2766,3941,1149,2720,1617,3039,1611,2759,8199,6878,77173,20228,19618,12145,41424,12900,38164,12184,3260,4386,1431,2899,1829,3256,6197,5569,9934,7472
53007,61257,17156,30390,10168,9986,6527,16114,5859,14783,5469,1331,1920,347,982,984,1609,980,1412,3310,3104,30867,9777,7605,5563,16237,5831,14892,5343,1345,1790,551,1228,794,1267,2374,1950,4651,3639
53009,64698,11638,31689,7203,9593,5156,16591,4563,15568,4337,1023,1338,286,802,737,1163,1435,1559,4070,2757,33009,6837,6300,3671,17270,4630,16123,4447,1147,1387,474,948,673,1132,3898,2499,5541,3186
53011,378791,69624,185585,42101,56992,27909,105056,26300,97850,24886,7206,8360,3170,5840,4036,6179,3908,5624,19629,13955,193206,40159,47097,23861,105259,26314,98096,24994,7163,8195,3215,5660,3948,6043,14426,11179,26424,16056
53013,3331,662,1602,340,345,160,1040,296,981,283,59,72,2,51,57,81,59,73,158,119,1729,402,220,164,1021,319,995,320,26,64,24,63,2,52,232,129,256,148
53015,86567,21602,42656,12771,12870,7909,22415,7969,20623,7465,1792,2453,883,1757,909,1817,1382,2144,5989,4494,43911,12090,10190,6566,22922,8153,21106,7658,1816,2379,955,1802,861,1682,4360,3495,6439,4759
53017,32876,6675,16445,4078,5163,2699,9282,2557,8578,2385,704,826,186,446,518,691,429,626,1571,1299,16431,3696,3957,2083,9024,2523,8322,2313,702,927,261,631,441,666,1444,1135,2006,1330
53019,6544,1319,3287,783,1031,505,1726,481,1597,475,129,124,28,69,101,113,82,96,448,285,3257,730,904,454,1597,488,1476,487,121,116,62,89,59,94,364,218,392,205
53021,66406,16730,34760,9907,13005,6429,17921,6239,16016,5589,1905,2081,504,992,1401,1777,583,1114,3251,2623,31646,9208,10034,5880,16226,5669,14598,5043,1628,1958,754,1291,874,1469,1930,2003,3456,2906
53023,1861,320,917,186,154,108,590,142,561,141,29,36,22,32,7,24,21,29,152,101,944,192,157,97,654,149,627,153,27,46,22,45,5,32,69,52,64,45
53025,71740,16205,36552,9691,13144,6362,18637,5773,16997,5332,1640,1816,358,818,1282,1593,920,1216,3851,3053,35188,9202,9368,5310,18240,5657,16061,5080,2179,2325,1170,1529,1009,1462,3041,2340,4539,3215
53027,60442,14474,31049,8488,9984,5145,15456,5365,13817,5071,1639,1511,429,924,1210,1282,1082,1287,4527,3073,29393,8109,6635,4111,15144,5330,13903,5051,1241,1682,656,1236,585,1193,2938,2309,4676,3253
53029,70112,13015,34964,7837,9360,4692,21281,5318,19988,5064,1293,1626,468,1034,825,1272,1034,1311,3289,2536,35148,7267,6535,3922,21080,5216,19904,5052,1176,1452,377,926,799,1195,2874,2102,4659,2975
53031,28021,5986,13735,3517,3335,2163,7921,2523,7663,2468,258,449,80,343,178,415,628,734,1851,1402,14286,3399,2383,1672,8213,2531,7718,2461,495,638,176,435,319,529,1395,1109,2295,1536
53033,1818550,377246,908434,233857,346583,168373,473323,142275,435173,131705,38150,47417,10203,26078,27947,39805,15431,27979,73097,64825,910116,221078,282419,145951,464977,138742,430946,130647,34031,42944,12968,27802,21063,33643,56753,51958,105967,77079
53035,220374,41411,112675,25692,38105,17123,60260,16313,56874,15610,3386,4451,1129,2840,2257,3647,2872,4005,11438,8729,107699,23120,23713,12873,60290,16142,55423,15181,4867,5326,2147,3641,2720,3922,8793,6887,14903,9354
53037,39277,7671,19699,4757,8035,3444,8870,2538,8391,2504,479,657,101,352,378,605,613,677,2181,1409,19578,4469,7462,2950,8858,2565,8179,2437,679,766,317,528,362,541,1125,935,2133,1322
53039,18254,4824,9162,2811,2488,1614,5023,1811,4621,1696,402,576,97,287,305,492,237,390,1414,1173,9092,2687,1743,1299,5316,1929,4972,1802,344,497,222,412,122,291,971,855,1062,944
53041,64378,13924,32014,8260,9550,5109,17056,5200,15398,4720,1658,1946,739,1264,919,1454,1005,1330,4403,3104,32364,7890,6870,4145,17298,5290,15757,4908,1541,1742,700,1163,841,1333,3232,2397,4964,3203
53043,8742,1311,4404,787,900,420,2853,582,2701,569,152,162,89,139,63,105,175,178,476,293,4338,745,674,357,2736,584,2615,563,121,154,63,133,58,129,541,341,387,242
53045,53449,14439,27561,8826,9376,5675,13241,4777,12197,4546,1044,1393,295,763,749,1247,979,1329,3965,3089,25888,7700,5707,3980,13156,4805,11901,4369,1255,1585,514,1002,741,1211,2951,2338,4074,2838
53047,33776,8937,17028,5412,4734,3184,9703,3765,8879,3470,824,1241,318,742,506,960,510,814,2081,1708,16748,4856,3723,2572,9324,3459,8759,3359,565,868,342,747,223,595,1534,1371,2167,1846
53049,18738,4173,9380,2430,2500,1343,5043,1563,4878,1536,165,282,51,247,114,257,474,538,1363,1000,9358,2326,1840,1245,5097,1633,4762,1570,335,454,216,368,119,304,1098,775,1323,837
53051,11385,2315,5726,1319,1536,732,3284,961,3104,937,180,219,54,169,126,188,119,209,787,512,5659,1321,1221,657,3083,911,2887,880,196,243,106,215,90,190,672,475,683,424
53053,704110,149937,348987,90766,121389,61979,182623,54053,169459,50927,13164,16462,5244,10913,7920,12732,6969,11483,38006,30041,355123,85179,95093,50923,180933,52821,166248,49572,14685,16894,6467,11650,8218,12677,26563,21927,52534,34426
53055,15008,1525,7219,892,1640,522,4439,644,4208,617,231,176,70,139,161,155,168,143,972,401,7789,926,1517,516,4490,654,4306,649,184,163,83,126,101,128,640,290,1142,392
53057,102580,17966,50410,10831,14954,7098,28402,6906,26524,6532,1878,2134,616,1299,1262,1726,1344,1607,5710,3605,52170,10214,11464,5885,28357,6732,26361,6377,1996,2002,832,1392,1164,1499,4655,2845,7694,4187
53059,9935,1535,4940,856,1326,549,2953,632,2844,631,109,125,39,107,70,108,102,120,559,337,4995,903,970,484,2929,647,2770,633,159,177,50,94,109,152,487,325,609,347
53061,647199,135236,322709,80121,105316,53705,176724,49624,163417,46379,13307,15855,3888,9372,9419,12986,6567,10337,34102,26049,324490,77118,81766,46276,176008,49445,163126,46252,12882,15699,4947,10075,7935,12124,22379,19537,44337,29801
53063,412059,80842,202691,49478,68648,33949,104298,30091,97816,28634,6482,8406,2455,5707,4027,6665,5205,7306,24540,18111,209368,47904,55368,29098,103927,29920,97230,28431,6697,9143,2660,6078,4037,7038,17736,13933,32337,20407
53065,36824,6843,18212,3993,4683,2336,10394,2619,9735,2487,659,780,209,471,450,683,550,605,2585,1530,18612,3931,3716,2090,10594,2675,10033,2608,561,689,341,573,220,462,1906,1274,2396,1505
53067,229553,44465,111019,26457,35539,18361,61813,16437,58124,15600,3689,4698,1288,2935,2401,3869,2580,3665,11087,8299,118534,26286,29507,15706,62066,16470,57545,15482,4521,5439,1856,3423,2665,4037,9529,7485,17432,10860
53069,3679,792,1739,413,311,198,1133,318,1035,300,98,94,67,83,31,59,73,85,222,159,1940,473,261,189,1301,375,1221,360,80,97,49,78,31,64,189,143,189,139
53071,49850,10014,25445,6265,9393,4111,12843,3929,11853,3738,990,1029,386,726,604,855,613,900,2596,1970,24405,5721,7106,3737,11954,3639,11231,3560,723,1041,421,827,302,730,2024,1524,3321,2233
53073,184808,34371,90484,21345,35162,15819,44803,11885,41401,11163,3402,3824,1338,2347,2064,3002,1979,2722,8540,6358,94324,20594,30128,13848,45645,12104,42460,11489,3185,3797,1538,2557,1647,2595,6630,4990,11921,7600
53075,42906,7724,21809,5222,11900,4300,8075,2240,7292,2090,783,830,273,595,510,686,363,561,1471,1145,21097,4585,10859,3555,7488,2074,6914,1992,574,695,135,436,439,613,882,746,1868,1218
53077,187308,44140,93000,25740,33928,16645,47587,16003,43584,15116,4003,4565,1572,2989,2431,3596,2646,3680,8839,7390,94308,25007,28217,15413,47615,15876,42227,14565,5388,5801,2793,3889,2595,3988,7966,6390,10510,7864
54001,13907,3806,6783,2172,2215,1299,3361,1277,3183,1237,178,331,57,240,121,279,162,247,1045,787,7124,2174,1712,1160,3526,1359,3257,1303,269,421,119,276,150,330,957,743,929,744
54003,92804,22628,45466,12823,13499,7865,25196,8214,23668,7806,1528,2185,938,1703,590,1323,1302,1857,5469,4462,47338,13168,11898,7362,24781,8170,22740,7562,2041,2646,842,1563,1199,1964,3515,3031,7144,5050
54005,18474,4005,9142,2319,2427,1344,4988,1467,4746,1438,242,382,62,241,180,355,292,356,1435,1015,9332,2210,1787,1104,5081,1536,4831,1464,250,382,135,312,115,274,1308,851,1156,830
54007,11875,3460,5979,1940,1570,1099,3458,1443,3227,1389,231,289,93,213,138,219,184,291,767,555,5896,1878,1103,825,3250,1320,2981,1304,269,338,128,241,141,255,727,581,816,672
54009,19284,4423,9426,2543,3012,1590,5062,1751,4839,1733,223,416,143,383,80,280,363,540,989,830,9858,2658,2374,1416,4821,1708,4572,1659,249,435,148,369,101,312,1279,1016,1384,1032
54011,78750,19304,38065,11923,14800,8199,16775,6343,15349,5853,1426,1953,588,1416,838,1591,1317,1945,5173,4214,40685,11686,12651,7296,17299,6548,15864,6048,1435,2181,620,1518,815,1687,4349,3593,6386,4574
54013,6080,1416,2985,779,616,396,1768,571,1673,562,95,137,75,124,20,73,107,128,494,357,3095,823,527,374,1862,633,1793,622,69,123,67,118,2,67,294,233,412,312
54015,7095,1907,3483,1061,949,564,1871,656,1765,629,106,172,56,147,50,126,93,145,570,388,3612,1063,855,591,1807,640,1682,608,125,177,63,142,62,114,392,315,558,417
54017,7512,2036,4196,1311,1481,778,2043,709,1826,659,217,206,95,154,122,168,181,211,491,411,3316,992,602,466,1976,695,1738,626,238,260,17,106,221,256,409,313,329,271
54019,36050,9311,18147,5423,5304,3169,9536,3580,8923,3456,613,862,198,588,415,779,834,998,2473,1817,17903,5162,3530,2335,9470,3607,8941,3398,529,876,234,636,295,708,2513,1827,2390,1891
54021,7017,1681,4149,1104,2052,778,1564,593,1344,547,220,198,61,139,159,185,81,137,452,296,2868,895,743,383,1465,592,1336,552,129,217,67,165,62,160,377,323,283,241
54023,9827,2013,4928,1242,1367,731,2463,793,2299,760,164,227,25,110,139,218,332,315,766,459,4899,1178,1226,744,2510,794,2288,738,222,299,26,122,196,302,508,344,655,425
54025,29494,7341,14283,4355,4237,2564,7337,2732,6989,2666,348,572,184,477,164,424,810,953,1899,1558,15211,4290,3466,2362,7127,2684,6755,2589,372,605,177,499,195,461,2047,1526,2571,1756
54027,19704,4939,9975,2823,3026,1596,5180,1833,4840,1748,340,439,122,319,218,344,422,535,1347,1028,9729,2775,2062,1306,5287,1883,4889,1825,398,489,210,373,188,320,1045,815,1335,954
54029,24828,6470,11852,3825,3713,2390,5951,2255,5499,2113,452,727,231,563,221,544,560,721,1628,1429,12976,3994,2931,2187,6258,2418,5634,2203,624,887,263,602,361,707,1926,1429,1861,1519
54031,11493,3169,5839,1834,1461,941,3713,1335,3503,1253,210,280,73,185,137,240,147,243,518,507,5654,1680,996,714,3604,1249,3397,1190,207,314,91,218,116,245,561,510,493,479
54033,55852,12034,26956,6899,8249,4347,14449,4245,13589,4049,860,1250,286,812,574,1092,945,1248,3313,2671,28896,7024,6788,4073,15058,4379,13792,4083,1266,1593,530,1006,736,1282,3261,2246,3789,2561
54035,23804,6843,11663,4062,3247,2475,6800,2626,6478,2511,322,592,107,373,215,495,415,618,1201,1252,12141,3891,2465,1950,6652,2501,6366,2442,286,513,25,280,261,505,1532,1281,1492,1343
54037,46093,7079,22573,4137,7013,2787,12752,2751,12109,2701,643,741,209,495,434,632,503,666,2305,1376,23520,4137,5763,2578,12982,2753,12058,2634,924,912,638,802,286,526,2119,1477,2656,1556
54039,152805,38632,73002,22662,23066,14387,36552,13515,34219,12851,2333,3790,1029,2857,1304,2956,2501,3693,10883,8574,79803,23084,19685,13032,37500,13740,34614,12994,2886,4212,1589,3317,1297,2974,9820,7729,12798,9229
54041,13278,2852,6638,1703,1929,1051,3522,1138,3322,1107,200,306,88,249,112,249,200,272,987,687,6640,1648,1307,808,3779,1226,3551,1176,228,333,144,270,84,242,674,503,880,613
54043,16926,5572,8341,3103,2284,1744,4745,2046,4500,1967,245,449,108,341,137,366,343,570,969,978,8585,3103,1408,1214,5107,2203,4929,2136,178,412,105,341,73,309,1088,997,982,1004
54045,27532,7832,13578,4510,3411,2208,7568,2993,7223,2948,345,610,123,439,222,536,665,912,1934,1565,13954,4352,2324,1909,7631,3039,7206,2964,425,644,221,535,204,506,2317,1761,1682,1461
54047,15488,5155,7902,3204,2480,1622,3937,1824,3359,1628,578,670,270,500,308,500,388,577,1097,936,7586,2707,1368,1171,3782,1780,3512,1712,270,455,186,410,84,348,1421,1092,1015,954
54049,46942,11616,22909,6762,7559,4293,11780,4088,10976,3874,804,1261,344,920,460,1022,731,1064,2839,2376,24033,6843,5984,3965,12499,4254,11869,4155,630,1082,419,945,211,814,2616,2151,2934,2293
54051,26245,7963,12964,4562,3869,2765,6989,2887,6447,2670,542,834,157,498,385,707,602,820,1504,1373,13281,4460,2813,2210,7003,2989,6337,2614,666,945,182,559,484,813,1759,1382,1706,1443
54053,22097,6206,10505,3449,2361,1722,6327,2449,6091,2393,236,432,155,377,81,331,276,448,1541,1234,11592,3444,2065,1559,6612,2481,6160,2411,452,639,229,476,223,455,1517,1062,1398,1123
54055,49717,12793,23234,7184,6821,4226,12299,4632,11455,4403,844,1209,380,899,464,954,913,1302,3201,2616,26483,7541,6003,3895,12586,4821,11712,4532,874,1325,296,831,578,1098,3575,2557,4319,3055
54057,22775,5243,11310,3141,3375,1831,5967,1957,5768,1934,199,351,35,222,164,349,596,659,1372,1148,11465,2887,2498,1442,6341,2062,5702,1963,639,669,307,437,332,505,1204,879,1422,1152
54059,19881,4858,9564,2832,2316,1423,5359,1936,5185,1890,174,390,100,360,74,313,390,558,1499,1167,10317,2713,1756,1269,5619,2001,5219,1928,400,561,302,521,98,332,1613,1078,1329,1038
54061,90848,25209,46891,16640,23847,13308,18126,7259,16477,6611,1649,2519,388,1562,1261,2145,835,1820,4083,4011,43957,15358,18428,11429,17848,7114,16536,6535,1312,2371,323,1456,989,2136,3021,2991,4660,4114
54063,11268,2836,5580,1551,1226,775,3078,1113,2876,1099,202,283,70,187,132,248,409,491,867,613,5688,1709,1130,881,2941,1147,2822,1109,119,217,51,169,68,188,795,573,822,604
54065,15079,3872,7484,2248,1845,1200,4300,1466,4114,1461,186,325,28,164,158,317,445,427,894,746,7595,2127,1438,1038,4264,1454,4122,1415,142,260,65,204,77,212,968,693,925,691
54067,20809,5332,10181,3191,2549,1794,5873,2109,5664,2043,209,415,45,299,164,368,442,620,1317,1194,10628,2952,2014,1498,5637,1965,5411,1930,226,453,117,368,109,345,1192,1011,1785,1341
54069,35506,8092,16933,4897,6076,3192,8398,2823,7694,2616,704,1024,237,679,467,893,590,892,1869,1585,18573,4874,5819,3212,7980,2762,7369,2552,611,968,268,765,343,757,2296,1605,2478,1774
54071,5962,1196,3064,710,766,434,1727,510,1634,501,93,138,23,105,70,128,154,158,417,275,2898,651,456,292,1647,486,1583,472,64,129,34,109,30,113,442,275,353,252
54073,6391,1214,3470,741,1097,491,1718,513,1636,491,82,125,32,98,50,99,193,137,462,242,2921,618,488,280,1729,477,1645,456,84,127,45,115,39,96,350,217,354,234
54075,7235,1490,3737,905,942,510,1895,572,1752,562,143,169,66,121,77,143,293,270,607,355,3498,834,743,453,1873,552,1768,548,105,140,50,111,55,112,484,334,398,279
54077,28262,6389,14469,3669,4770,2138,7508,2337,6860,2263,648,644,326,515,322,544,537,676,1654,1299,13793,3750,2872,1873,7747,2462,7181,2389,566,684,358,594,208,493,1626,1135,1548,1163
54079,46253,10923,22521,6098,5963,3640,13398,4038,12801,3882,597,1014,337,775,260,697,827,1104,2333,2073,23732,6501,4788,3280,13276,4063,12566,3851,710,1125,415,910,295,697,2457,2015,3211,2489
54081,62127,15837,30927,9293,8596,5084,16773,6099,15468,5908,1305,1445,395,875,910,1292,1195,1536,4363,3343,31200,8814,6578,4361,16243,5847,15135,5656,1108,1516,576,1183,532,1105,4027,3266,4352,3408
54083,24350,5748,12563,3516,4076,2134,6270,2255,5759,2186,511,604,35,322,476,594,565,711,1652,1223,11787,3289,2736,1741,5816,2151,5394,2082,422,609,133,457,289,478,1319,960,1916,1271
54085,8232,1709,4067,1007,1114,586,2388,687,2282,679,106,172,61,155,45,135,164,183,401,323,4165,960,834,475,2276,675,2191,669,85,147,43,118,42,139,490,363,565,377
54087,11602,3088,5724,1738,1607,1021,2993,1068,2831,1029,162,292,48,210,114,261,233,317,891,690,5878,1752,1314,915,3177,1104,3043,1090,134,278,41,221,93,252,597,476,790,628
54089,11116,2943,5043,1662,1308,820,2898,1230,2757,1206,141,257,59,184,82,203,248,316,589,549,6073,1671,1200,675,3190,1244,2840,1197,350,283,64,185,286,284,865,699,818,520
54091,14022,4271,7036,2389,2045,1391,3765,1621,3489,1500,276,468,104,324,172,397,227,366,999,883,6986,2524,1694,1526,3629,1522,3422,1466,207,445,172,419,35,273,828,775,835,895
54093,6106,1059,3076,623,902,379,1614,422,1500,415,114,125,19,86,95,118,191,178,369,225,3030,617,510,291,1760,452,1636,441,124,120,34,91,90,99,439,260,321,210
54095,7390,1789,3665,1060,1022,633,1988,682,1766,624,222,265,77,151,145,220,105,159,550,408,3725,1006,901,608,1874,622,1680,571,194,224,58,122,136,196,549,345,401,281
54097,20326,4397,10083,2580,3058,1534,5042,1802,4656,1722,386,524,175,365,211,398,397,528,1586,1160,10243,2671,2388,1373,4821,1724,4387,1578,434,604,223,428,211,410,1307,978,1727,1140
54099,33447,9619,16196,5535,4909,3317,8622,3408,8054,3140,568,993,238,633,330,775,670,927,1995,1757,17251,5629,3764,2813,8444,3291,7866,3101,578,875,338,736,240,627,2548,2046,2495,2052
54101,7012,1725,3468,896,802,432,2003,683,1899,675,104,145,80,132,24,90,102,122,561,344,3544,998,669,445,1916,666,1813,642,103,152,32,77,71,140,419,259,540,378
54103,12835,3295,6239,1799,2190,1237,3137,1095,2831,1018,306,422,124,304,182,324,234,284,678,606,6596,1959,1768,1104,3009,1098,2744,983,265,428,161,342,104,295,971,654,848,698
54105,4776,942,2431,551,480,282,1547,442,1442,429,105,103,33,63,72,98,59,76,345,183,2345,486,369,216,1498,425,1440,402,58,95,21,56,37,84,185,139,293,200
54107,70144,14644,33675,8645,9892,5378,18022,5523,17188,5324,834,1453,471,1196,363,1053,1495,1794,4266,3153,36469,8621,8456,4934,17911,5516,16910,5228,1001,1580,594,1296,407,1138,4310,3041,5792,3749
54109,17742,4755,8649,2545,1861,1261,5328,1890,5228,1893,100,272,21,228,79,263,389,532,1071,865,9093,2779,1440,1102,5417,1923,5210,1886,207,375,133,327,74,271,1106,946,1130,928
55001,17711,2185,9557,1389,2533,807,5169,958,4692,851,477,348,215,246,262,233,429,302,1426,585,8154,1140,1255,516,4783,855,4597,835,186,201,79,141,107,167,1035,470,1081,480
55003,12750,1920,6418,1131,2369,807,3013,738,2867,714,146,194,66,176,80,152,173,195,863,488,6332,1173,1721,673,3000,763,2789,706,211,286,102,207,109,207,757,424,854,506
55005,37057,5398,18374,3278,5092,2128,10508,2165,10016,2080,492,556,130,352,362,487,679,721,2095,1239,18683,3162,3473,1612,10606,2368,9809,2072,797,916,292,570,505,712,2069,1191,2535,1351
55007,12883,1190,6544,723,1491,485,4026,537,3926,539,100,103,33,109,67,87,278,186,749,295,6339,713,1080,401,4054,558,3921,535,133,157,53,127,80,130,569,257,636,292
55009,209360,34676,103134,21497,35441,15421,55034,13835,52632,13266,2402,3600,750,2269,1652,2938,2701,3622,9958,7479,106226,20912,30952,14151,55434,13633,52541,13132,2893,3776,1364,2781,1529,2748,7807,6129,12033,8238
55011,10937,1105,5597,670,1460,441,3365,496,3236,478,129,125,39,72,90,109,116,109,656,301,5340,637,937,343,3253,511,3146,507,107,112,37,104,70,87,498,245,652,300
55013,13078,1202,6637,752,1615,570,3902,536,3739,531,163,127,81,95,82,85,273,162,847,303,6441,670,1223,420,3912,522,3795,522,117,125,59,91,58,84,607,216,699,272
55015,40169,4778,20045,3043,5602,2192,12719,2089,12432,2051,287,481,80,339,207,415,386,495,1338,941,20124,2893,4093,1791,12909,2138,12542,2110,367,505,68,321,299,485,1319,917,1803,1182
55017,52093,7413,27163,4621,8432,3320,14907,3047,14251,2961,656,684,168,464,488,601,788,815,3036,1807,24930,4252,5261,2534,14424,3032,13937,2866,487,723,272,619,215,513,2468,1521,2777,1660
55019,26110,2680,13185,1674,3822,1123,7546,1079,7238,1032,308,325,114,235,194,257,333,280,1484,656,12925,1542,2862,944,7706,1076,7422,1038,284,306,146,269,138,231,1294,569,1063,488
55021,47116,5965,24115,3811,7255,2716,13684,2561,13144,2474,540,645,205,464,335,506,635,673,2541,1423,23001,3472,4695,2220,13474,2503,12828,2389,646,746,271,505,375,582,2024,1189,2808,1455
55023,13584,1639,7044,991,2303,693,3643,613,3444,584,199,204,55,141,144,172,306,224,792,369,6540,1009,1421,553,3658,659,3455,618,203,213,81,131,122,188,692,401,769,381
55025,443910,69218,219202,45611,92197,37049,106361,24825,101274,23684,5087,6993,1607,4234,3480,5690,3447,5274,17197,12767,224708,43320,80493,32573,106715,24843,101482,23686,5233,6868,2138,4570,3095,5355,13957,10915,23543,15056
55027,73056,10805,38305,6869,12973,4866,19572,4239,18505,4105,1067,1045,314,719,753,918,1093,1140,4667,2647,34751,6141,7964,3816,19037,4161,18257,4053,780,1099,353,816,427,840,3384,2000,4366,2495
55029,23874,3546,11650,2133,2515,1340,7975,1585,7733,1541,242,324,81,249,161,278,207,276,953,694,12224,1973,1730,926,8019,1590,7693,1517,326,453,154,363,172,306,1227,672,1248,768
55031,36160,5592,18063,3605,5957,2518,9056,2205,8514,2106,542,707,95,388,447,639,534,594,2516,1476,18097,3381,4984,2202,8884,2172,8274,2034,610,774,263,573,347,592,1800,1164,2429,1396
55033,37422,5317,18655,3404,7603,2597,8750,1777,8344,1716,406,482,159,321,247,385,477,484,1825,974,18767,3119,6369,2188,8775,1845,8328,1741,447,532,169,355,278,437,1457,769,2166,1109
55035,85989,16391,42077,10449,17110,8639,20058,5163,19244,5018,814,1240,293,832,521,1019,929,1239,3980,2890,43912,10158,15718,7517,19747,4990,18774,4802,973,1336,316,870,657,1078,3231,2331,5216,3362
55037,3755,529,1956,314,452,183,1153,224,1092,216,61,57,9,35,52,54,58,57,293,124,1799,285,271,126,1161,232,1127,229,34,37,12,35,22,28,160,114,207,108
55039,84576,14521,41392,8942,12613,5891,23304,5658,22338,5488,966,1368,332,1001,634,1107,1228,1429,4247,3222,43184,8663,10612,5226,23861,5871,22774,5645,1087,1489,492,1143,595,1072,3989,2827,4722,3135
55041,7503,913,3788,540,1082,368,2061,348,1923,323,138,137,37,64,101,125,154,145,491,185,3715,535,827,313,2040,363,1930,339,110,102,29,73,81,83,402,191,446,206
55043,42849,6262,22321,4167,9554,3344,10544,2114,10093,2045,451,529,96,364,355,491,531,535,1692,1011,20528,3490,6428,2556,10365,2060,9893,2009,472,592,144,408,328,516,1906,1046,1829,1084
55045,30113,3943,14887,2377,4291,1648,8516,1574,8129,1504,387,508,158,331,229,417,388,427,1692,1008,15226,2420,3431,1460,8297,1530,8030,1485,267,396,120,305,147,342,1382,792,2116,1096
55047,15369,2192,7744,1299,2203,906,4396,852,4214,816,182,253,20,164,162,252,277,254,868,507,7625,1272,1591,731,4441,868,4300,853,141,205,44,182,97,169,866,459,727,449
55049,19149,2367,9597,1417,2901,1006,5572,894,5414,880,158,195,45,153,113,181,291,294,833,424,9552,1356,2073,840,5550,908,5384,889,166,196,43,145,123,175,811,410,1118,573
55051,5036,590,2557,344,604,220,1442,243,1333,229,109,97,34,69,75,81,127,95,384,148,2479,352,439,201,1362,258,1306,248,56,67,12,63,44,69,325,156,353,148
55053,16819,2065,9074,1303,3219,899,4278,790,3992,752,286,228,60,144,226,208,332,244,1245,512,7745,1145,1684,647,4119,743,3957,735,162,169,80,140,82,136,906,439,1036,499
55055,70016,10160,34778,6288,11235,4390,19042,4319,18237,4137,805,1078,217,655,588,921,1034,1116,3467,2360,35238,6271,9064,4004,18893,4239,18151,4097,742,1052,294,749,448,814,2842,1970,4439,2615
55057,22106,2798,11853,1864,3968,1331,5705,1076,5298,990,407,349,110,198,297,318,318,299,1862,779,10253,1509,1966,819,5902,1063,5624,1026,278,271,153,239,125,211,1098,528,1287,594
55059,136742,29202,67130,17422,25039,12155,33160,10099,31434,9684,1726,2637,756,1872,970,2001,2006,2694,6925,5799,69612,17174,21564,11111,33271,9983,30875,9428,2396,3053,1031,2050,1365,2340,5235,4300,9542,6608
55061,16870,1987,8507,1250,2466,875,5046,836,4867,802,179,256,28,145,151,240,179,207,816,480,8363,1217,1690,712,5166,830,5005,815,161,208,33,157,128,190,691,432,816,509
55063,98453,17682,47513,11360,18890,8976,23185,5788,21988,5512,1197,1620,437,1141,760,1320,1120,1532,4318,3447,50940,11088,17985,8532,23167,5793,22194,5598,973,1440,401,1067,572,1200,4311,3099,5477,3628
55065,13385,1370,6754,840,1991,587,3743,559,3648,558,95,107,38,102,57,100,249,167,771,367,6631,772,1515,474,3800,547,3702,534,98,138,33,91,65,127,606,280,710,305
55067,16169,2729,8156,1710,2376,1118,4449,1094,4327,1089,122,188,29,165,93,173,266,271,1065,666,8013,1540,1433,824,4677,1141,4503,1117,174,250,81,224,93,169,932,544,971,654
55069,23688,3185,11913,1968,3123,1396,6861,1381,6573,1353,288,337,115,274,173,274,428,379,1501,846,11775,1860,2129,1027,6907,1437,6660,1420,247,342,40,238,207,314,1329,726,1410,789
55071,65825,11164,32613,6683,9806,4403,18194,4381,17383,4228,811,1094,311,853,500,871,1288,1422,3325,2429,33212,6669,7401,4059,18318,4362,17649,4259,669,1030,361,891,308,763,3674,2220,3819,2608
55073,109734,16725,54801,10110,16472,7001,31820,6581,30444,6378,1376,1749,445,1119,931,1459,1305,1523,5204,3425,54933,9637,12560,5910,31924,6697,30630,6421,1294,1701,524,1229,770,1406,5009,3291,5440,3630
55075,34206,5950,17123,3594,4674,2346,9170,2231,8727,2194,443,593,126,374,317,532,626,637,2653,1646,17083,3458,3540,1962,9451,2338,9013,2275,438,629,234,523,204,438,2031,1254,2061,1316
55077,12827,1309,6516,810,1708,519,3550,526,3349,502,201,167,61,128,140,134,286,177,972,354,6311,724,1046,391,3522,526,3325,500,197,144,49,116,148,123,907,326,836,321
55078,3368,405,1661,252,814,208,598,156,567,157,31,39,14,24,17,35,47,47,202,99,1707,251,661,177,638,165,523,160,115,93,27,42,88,86,182,92,226,117
55079,758325,170820,362098,105235,172159,81769,147593,54466,135309,50420,12284,17664,4439,11374,7845,14374,9011,14411,33335,29580,396227,105435,169205,78860,147950,54429,133010,49561,14940,19788,7093,13722,7847,14498,31489,26317,47583,34802
55081,36112,5383,18323,3300,5668,2324,9628,1951,8881,1818,747,708,222,401,525,576,520,506,2507,1331,17789,3113,4052,1781,9679,2014,9243,1887,436,536,187,402,249,408,1799,1051,2259,1143
55083,31419,3481,15989,2127,4097,1420,9437,1465,9105,1422,332,370,120,251,212,309,536,411,1919,871,15430,1993,3068,1191,9384,1453,9028,1402,356,420,144,303,212,304,1413,698,1565,751
55085,30371,5231,15108,3165,3982,2157,8790,1938,8415,1865,375,540,118,407,257,450,614,558,1722,1150,15263,3002,2922,1654,8865,1991,8525,1941,340,475,59,336,281,455,1624,1088,1852,1115
55087,149315,23855,73923,15128,25003,11222,40152,9401,38749,9142,1403,2152,636,1707,767,1680,1744,2330,7024,5216,75392,13917,19615,9138,41086,9454,39567,9218,1519,2273,570,1627,949,1873,5791,4416,8900,5971
55089,73194,11609,35658,7051,9648,4880,22550,4711,21769,4623,781,1198,207,686,574,1055,1038,1228,2422,2070,37536,7074,8316,4556,22152,4630,21402,4566,750,1167,230,732,520,988,3196,2296,3872,2694
55091,5991,516,3021,322,787,219,1780,241,1705,232,75,69,35,58,40,56,80,61,374,160,2970,306,539,176,1781,229,1718,223,63,55,17,52,46,52,266,102,384,170
55093,34696,4595,17010,2905,6198,2290,9010,1578,8663,1507,347,356,116,250,231,293,269,331,1533,821,17686,2877,5976,2099,8848,1529,8633,1509,215,278,103,227,112,233,1188,789,1674,906
55095,35896,3755,18032,2252,4574,1412,10573,1567,10196,1559,377,366,133,286,244,314,550,426,2335,992,17864,2204,3566,1312,10548,1619,10140,1556,408,452,164,314,244,348,1569,757,2181,966
55097,59362,8559,29725,5403,11591,4154,14647,3009,14124,2885,523,789,141,505,382,705,812,908,2675,1727,29637,5015,9596,3568,14718,3037,14047,2899,671,888,258,611,413,716,2374,1448,2949,1700
55099,11607,1495,5881,989,1454,726,3358,702,3271,708,87,122,21,114,66,111,227,181,842,373,5726,881,990,489,3363,640,3192,621,171,207,46,150,125,160,576,311,797,398
55101,158122,35504,77603,21334,27179,14766,40096,12415,37839,11902,2257,3284,801,2135,1456,2697,2133,3040,8195,6689,80519,20601,23573,13646,41144,13083,38811,12315,2333,3490,901,2363,1432,2764,6348,5528,9454,7189
55103,14343,1699,7160,1058,1982,662,3945,669,3757,647,188,172,63,120,125,139,244,195,989,503,7183,1019,1670,669,3879,666,3757,648,122,142,44,104,78,132,694,362,940,468
55105,131014,22678,63803,14073,21911,10048,32597,8674,30886,8259,1711,2310,728,1663,983,1756,1724,2198,7571,5324,67211,13607,18801,9082,32319,8423,30114,8017,2205,2691,1020,1864,1185,1933,6239,4408,9852,5918
55107,11794,1387,5911,852,1492,569,3487,581,3320,571,167,166,55,108,112,153,198,161,734,314,5883,792,1095,463,3367,568,3225,562,142,146,41,81,101,129,716,308,705,322
55109,70382,8655,34924,5216,9683,3777,21550,3712,20815,3600,735,888,185,487,550,789,487,632,3204,1968,35458,5243,8413,3465,20895,3643,20253,3552,642,764,289,589,353,558,2295,1371,3855,1966
55111,51848,6063,25693,3895,7984,2877,14400,2572,13645,2505,755,790,212,425,543,660,689,643,2620,1359,26155,3687,5805,2274,14442,2671,13710,2582,732,703,431,541,301,454,2678,1317,3230,1560
55113,13759,1961,7047,1229,1715,829,4095,860,3899,842,196,189,62,147,134,162,272,225,965,436,6712,1065,1298,549,3958,812,3805,793,153,190,70,184,83,143,614,338,842,409
55115,33664,3603,16737,2237,4844,1540,9432,1493,9094,1451,338,347,79,240,259,302,570,424,1891,883,16927,2219,3735,1332,9538,1566,9193,1521,345,386,115,274,230,332,1771,821,1883,871
55117,94181,12726,47279,7996,15069,5864,26332,5244,25202,5048,1130,1348,396,865,734,1094,1255,1324,4623,2828,46902,7853,10839,5018,26215,5275,24893,4957,1322,1582,483,901,839,1274,4234,2541,5614,3094
55119,16367,1720,8368,1072,2129,712,5204,757,5046,754,158,159,73,127,85,131,220,176,815,370,7999,976,1544,597,4890,680,4731,670,159,169,72,162,87,123,799,351,766,388
55121,23355,2387,11829,1481,3748,1064,6540,941,6254,918,286,253,99,189,187,225,383,295,1158,513,11526,1375,2592,867,6479,948,6152,907,327,288,171,226,156,215,1230,509,1225,521
55123,24014,3059,11978,1799,3337,1224,7029,1199,6751,1163,278,308,130,261,148,244,314,285,1298,669,12036,1867,2468,1040,6949,1195,6739,1177,210,263,100,234,110,210,1299,573,1320,680
55125,18819,2355,9444,1479,2099,913,5888,1083,5691,1067,197,195,54,114,143,173,382,300,1075,539,9375,1329,1497,668,5711,1033,5510,1009,201,236,97,178,104,188,1041,469,1126,551
55127,85434,15626,42366,9506,14823,6604,22789,5813,21659,5558,1130,1533,370,971,760,1301,919,1243,3835,2758,43068,9386,12261,6028,22991,5804,21618,5529,1373,1730,477,1063,896,1435,3231,2458,4585,3061
55129,13226,1289,6554,739,1365,429,4211,569,4069,568,142,132,37,87,105,112,211,171,767,301,6672,773,972,393,4154,571,3992,562,162,123,69,123,93,116,762,322,784,341
55131,110646,16189,54751,10086,15189,7114,32622,6653,31918,6608,704,1231,169,867,535,1139,1326,1729,5614,4194,55895,9783,11937,6015,33004,6823,32043,6695,961,1514,468,1176,493,1139,4901,3196,6053,3901
55133,330580,53896,161353,32830,45417,23126,99340,21268,96462,20542,2878,4997,658,3247,2220,4479,3869,5105,12727,10459,169227,31934,38766,20979,99258,21110,96259,20532,2999,5084,1071,3632,1928,4198,14577,10131,16626,11617
55135,42728,5801,21765,3730,6122,2445,11998,2372,11294,2245,704,735,288,524,416,544,962,905,2683,1564,20963,3369,4433,2031,11573,2250,11177,2199,396,542,212,459,184,384,2253,1271,2704,1531
55137,20536,2346,10893,1453,3068,905,5903,944,5583,909,320,239,105,178,215,215,312,242,1610,627,9643,1308,1656,727,5878,950,5668,925,210,215,86,177,124,174,1092,435,1017,440
55139,141454,24841,71007,15612,27423,11855,34114,8989,32451,8645,1663,2187,584,1641,1079,1744,1532,2192,7938,5235,70447,15063,20954,10206,34426,9234,32973,8914,1453,2295,642,1707,811,1782,6062,4301,9005,5855
55141,59989,10250,29387,6328,8534,4164,16309,4167,15675,4015,634,1022,312,872,322,772,1009,1253,3535,2487,30602,6288,6950,3792,16500,4282,15809,4162,691,1040,134,654,557,1007,3034,2045,4118,2797
56001,33091,6792,17113,4563,8584,3798,6933,2215,6620,2133,313,532,35,363,278,507,291,520,1305,1176,15978,4016,7051,3220,6788,2097,6416,2032,372,563,184,436,188,459,798,791,1341,1092
56003,9449,1622,4815,976,1389,577,2790,653,2627,635,163,174,42,98,121,159,148,149,488,281,4634,918,985,476,2522,601,2412,588,110,139,30,93,80,123,552,304,575,341
56005,36026,8829,18531,5127,5195,3081,10820,3393,10007,3170,813,1087,408,732,405,738,416,681,2100,1714,17495,4958,3756,2610,11028,3546,10576,3382,452,647,184,470,268,550,748,914,1963,1512
56007,12261,2686,6560,1540,2057,994,3417,1061,3090,1013,327,328,82,170,245,302,147,214,939,581,5701,1500,1274,741,3277,1028,3044,992,233,325,142,289,91,211,515,435,635,513
56009,11062,2741,5634,1568,1122,798,3498,1124,3331,1111,167,250,49,153,118,241,192,285,822,626,5428,1566,1108,773,3229,1091,3131,1079,98,194,81,205,17,121,382,427,709,584
56011,5899,1097,2996,634,654,395,1945,463,1852,456,93,92,8,47,85,105,16,58,381,236,2903,614,417,276,1933,476,1871,467,62,89,3,53,59,89,280,177,273,190
56013,31310,5114,15655,3228,5137,2260,7955,1991,7432,1952,523,571,280,480,243,397,485,532,2078,1321,15655,2882,4145,1758,7995,2079,7473,1971,522,670,174,421,348,562,1441,987,2074,1171
56015,11077,2336,5742,1542,1544,910,3157,938,2918,896,239,254,58,146,181,230,273,259,768,568,5335,1288,971,625,3052,908,2802,845,250,352,34,145,216,344,639,463,673,489
56017,3830,563,1870,342,411,222,1151,296,1138,294,13,48,2,28,11,48,89,78,219,118,1960,341,327,190,1120,290,1114,290,6,25,0,48,6,25,241,152,272,158
56019,6873,1197,3576,728,638,386,2331,701,2249,691,82,131,20,71,62,114,93,135,514,399,3297,686,504,335,2056,609,1970,599,86,131,50,112,36,74,342,246,395,330
56021,79217,16842,40073,10432,12277,6738,21612,6749,20546,6571,1066,1468,395,1051,671,1245,1210,1727,4974,3691,39144,9322,8237,5017,21716,6476,20234,6238,1482,1951,798,1558,684,1256,3171,2737,6020,4113
56023,14917,3401,7550,1978,1929,1017,4648,1448,4341,1396,307,338,149,245,158,250,186,260,787,621,7367,1892,1570,1051,4629,1418,4327,1391,302,389,106,226,196,304,532,371,636,467
56025,64123,12092,31991,7553,10070,5336,17045,4666,16103,4534,942,1243,267,745,675,1019,987,1185,3889,2637,32132,7074,7710,4290,16620,4511,15655,4344,965,1254,569,1010,396,780,2840,2074,4962,2986
56027,2073,380,918,234,198,130,537,179,534,178,3,19,2,28,1,27,59,57,124,83,1155,231,258,111,628,188,486,160,142,94,38,43,104,75,76,62,193,107
56029,24201,5867,11859,3433,2892,1869,7233,2400,6942,2315,291,522,114,387,177,408,223,376,1511,1271,12342,3560,2580,1920,7184,2326,6879,2258,305,502,119,362,186,382,1350,1185,1228,1185
56031,7320,2072,3870,1277,903,733,2227,917,2067,913,160,227,79,161,81,154,153,209,587,479,3450,1119,389,431,2385,940,2300,948,85,172,71,171,14,112,309,361,367,367
56033,24889,5175,12372,3095,3423,1877,7363,2239,6927,2216,436,559,130,349,306,446,307,447,1279,970,12517,2990,2690,1673,6919,2160,6589,2113,330,441,148,340,182,364,1008,846,1900,1365
56035,7975,1621,4457,1082,974,672,2611,731,2248,651,363,336,71,139,292,332,50,76,822,584,3518,912,340,318,1983,587,1916,574,67,140,13,58,54,130,392,372,803,416
56037,33813,8294,17520,5120,5290,3283,9444,3024,8762,2842,682,934,209,601,473,778,395,737,2391,1996,16293,4612,3848,2682,9009,2935,8510,2777,499,850,296,724,203,524,1485,1359,1951,1486
56039,19342,5537,10009,3465,3729,2250,4957,2173,4528,1988,429,620,117,318,312,490,100,242,1223,1082,9333,3009,2859,1818,4955,2010,4575,1925,380,535,152,345,228,395,562,613,957,1012
56041,15485,4347,7815,2433,2066,1445,4758,1704,4638,1682,120,257,47,213,73,217,191,328,800,762,7670,2471,1490,1113,4581,1662,4433,1628,148,285,42,215,106,254,608,566,991,886
56043,6508,1294,3316,786,910,545,1928,536,1838,536,90,164,49,133,41,111,53,113,425,324,3192,746,602,395,1814,504,1807,505,7,95,7,95,0,96,337,253,439,303
56045,5808,1081,3098,676,748,402,1786,488,1633,477,153,143,53,97,100,119,131,122,433,246,2710,586,375,282,1700,493,1639,486,61,96,31,88,30,65,383,222,252,197
72001,14915,3428,7227,2036,3338,1539,3024,1025,2782,971,242,348,137,257,105,238,122,216,743,565,7688,2034,2791,1345,2988,976,2671,922,317,369,259,336,58,201,729,517,1180,716
72003,32412,9394,15770,5300,6599,3659,6900,2789,6297,2572,603,930,502,858,101,484,504,760,1767,1564,16642,5370,5669,3445,7420,2848,6486,2567,934,1167,603,911,331,758,1572,1445,1981,1573
72005,44578,11584,21306,6796,8968,4667,9081,3721,8148,3517,933,1208,502,977,431,901,689,1099,2568,2049,23272,6685,7373,4086,9346,3807,8130,3512,1216,1458,817,1201,399,928,2724,2162,3829,2608
72007,21712,5895,10428,3591,4895,2614,4337,1938,3741,1653,596,734,456,656,140,336,272,434,924,927,11284,3218,4594,2200,4222,1786,3677,1644,545,702,354,564,191,404,1185,843,1283,983
72009,19400,4508,9203,2668,3950,1906,3931,1431,3794,1398,137,310,50,247,87,275,329,446,993,800,10197,2568,3873,1740,3910,1384,3422,1276,488,599,228,383,260,464,1147,860,1267,831
72011,22961,7046,10973,3834,4519,2534,5018,2078,4185,1788,833,951,479,686,354,673,317,543,1119,1085,11988,4331,4008,2511,5300,2308,4158,1796,1142,1260,745,967,397,779,1176,984,1504,1269
72013,72641,20538,34280,11818,14006,8110,14502,6183,13254,5824,1248,1983,742,1574,506,1441,1280,1852,4492,3882,38361,12131,12375,7147,14522,6297,12933,5728,1589,2216,976,1786,613,1574,5087,3988,6377,4445
72015,14662,4782,6658,2790,3101,1877,2275,1218,2063,1159,212,352,57,229,155,326,298,464,984,969,8004,2901,3047,1833,2720,1571,2348,1362,372,536,228,408,144,350,880,717,1357,1104
72017,20157,6409,9407,3900,4115,2948,3782,2077,3385,1827,397,676,205,456,192,441,247,466,1263,1490,10750,3795,3895,2502,4056,2008,3245,1710,811,1028,409,642,402,734,1145,1077,1654,1337
72019,23174,6898,11296,4005,5430,2951,4336,1907,3766,1756,570,677,394,608,176,360,331,452,1199,1095,11878,3864,5385,2890,4311,1914,3696,1714,615,717,358,502,257,467,1027,816,1155,987
72021,152268,39099,70661,22378,30576,15483,28901,11660,25931,10880,2970,4008,1526,3182,1444,3024,2210,3482,8974,7099,81607,23296,28048,14717,30161,12142,26080,10975,4081,4861,2359,3772,1722,3416,9433,7055,13965,8754
72023,41372,14080,19372,7863,8524,5490,7769,3653,6845,3262,924,1450,351,840,573,1130,501,817,2578,2580,22000,8354,7566,5067,7531,3433,6556,3111,975,1304,551,958,424,894,2635,2132,4268,3103
72025,109066,32626,49865,18448,20801,12898,20100,9386,18229,8744,1871,3165,962,2441,909,2370,1525,2798,7439,6643,59201,19402,21856,12338,19811,9264,17721,8583,2090,3317,1210,2451,880,2452,6518,5598,11016,7391
72027,26806,6857,12735,4055,4567,2443,6162,2209,5712,2082,450,681,316,588,134,360,379,570,1627,1311,14071,3959,3838,2319,6252,2204,5660,2113,592,707,372,552,220,451,1640,1132,2341,1484
72029,37847,10763,17908,6424,8050,4716,7348,3044,6473,2772,875,1115,390,732,485,886,369,728,2141,1706,19939,5925,7083,3694,7147,2819,6150,2652,997,1102,661,905,336,684,2274,1775,3435,2278
72031,131130,36214,58938,20733,23759,13805,24804,11136,21842,10095,2962,4149,1716,3159,1246,2795,2221,3337,8154,7166,72192,21610,26430,13974,23650,10394,19614,9071,4036,4638,2549,3737,1487,2794,8800,6487,13312,8441
72033,20301,4881,9402,2895,4454,2231,3518,1383,3058,1285,460,679,297,557,163,496,329,573,1101,1000,10899,3059,4608,2099,3460,1465,3061,1342,399,622,181,478,218,536,1413,1184,1418,1127
72035,37219,9622,17738,5425,7570,3865,7392,2823,6744,2634,648,971,378,798,270,654,734,989,2042,1671,19481,5751,7126,3849,7670,2930,6855,2687,815,1080,590,911,225,618,1738,1442,2947,2109
72037,9792,2411,4514,1341,1789,947,1781,738,1597,713,184,262,104,220,80,199,215,297,729,545,5278,1499,1671,962,2157,870,1827,789,330,373,255,320,75,205,706,515,744,568
72039,13804,3624,6700,2046,3002,1505,2779,1030,2626,1002,153,275,72,212,81,231,243,305,676,570,7104,1996,2445,1274,3064,1153,2661,1016,403,450,196,326,207,323,699,484,896,689
72041,33160,8182,15906,4768,7206,3598,7164,2501,6386,2240,778,1002,369,677,409,717,439,610,1097,1151,17254,4812,7401,3458,6653,2396,5820,2127,833,1006,362,609,471,741,1871,1257,1329,1179
72043,32456,8767,15570,5346,7015,3847,6274,2577,5254,2154,1020,1234,532,826,488,793,365,552,1916,1614,16886,5055,7177,3679,6068,2502,5239,2163,829,1071,411,663,418,768,1495,1250,2146,1588
72045,16035,4813,7865,3044,4608,2460,2663,1252,2294,1094,369,524,216,386,153,320,121,253,473,520,8170,2771,4153,2186,2495,1233,2146,1082,349,467,233,398,116,287,932,616,590,594
72047,27736,8209,13265,4580,6051,3109,6061,2493,5305,2274,756,944,463,723,293,556,312,524,841,983,14471,4926,5789,3287,5755,2335,4996,2126,759,855,336,547,423,676,1427,1211,1500,1284
72049,1097,310,551,178,259,130,146,82,141,81,5,37,5,37,0,42,20,46,126,72,546,195,201,117,136,75,133,74,3,34,3,34,0,42,71,55,138,95
72051,30408,8328,14330,4806,5772,3353,6672,2581,5817,2295,855,960,384,668,471,690,427,644,1459,1271,16078,4881,5634,3054,6640,2484,5643,2258,997,1027,533,778,464,639,1229,1071,2575,1765
72053,26078,7101,11959,4158,5202,2714,4411,2090,4055,1983,356,625,203,511,153,488,465,705,1881,1479,14119,4106,4637,2415,4667,2096,3970,1958,697,862,473,752,224,545,1623,1235,3192,1901
72054,9738,2685,4597,1436,1728,985,2304,889,2095,863,209,344,113,228,96,216,82,162,483,469,5141,1543,1495,1036,2232,856,1995,801,237,294,118,210,119,203,442,397,972,681
72055,13584,4089,6459,2316,3322,1812,2334,1130,2057,1016,277,471,135,358,142,340,294,369,509,533,7125,2482,3249,1742,2378,1117,2102,1023,276,408,176,358,100,263,902,732,596,582
72057,34240,10675,16914,6239,8814,4651,5716,3046,5018,2893,698,979,331,769,367,694,383,745,2001,1694,17326,6530,6926,4253,6063,3300,5137,2923,926,1268,411,796,515,986,1890,1825,2447,1949
72059,15400,3931,7291,2208,3395,1653,2888,1127,2691,1079,197,353,102,294,95,283,270,352,738,650,8109,2312,3290,1580,2888,1117,2498,1045,390,490,252,390,138,327,821,626,1110,709
72061,75300,21957,34997,12937,14907,9054,14228,6162,12492,5376,1736,2484,857,1762,879,1681,1096,1777,4766,4120,40303,13012,14477,8585,14351,5957,12829,5476,1522,2272,710,1557,812,1764,5016,3867,6459,4626
72063,39232,11193,18266,5917,7613,4099,8332,3249,7480,2948,852,1129,162,433,690,1046,301,606,2020,1706,20966,7012,7434,4265,8800,3444,7711,3096,1089,1375,570,957,519,800,1679,1413,3053,2161
72065,33927,9573,16082,5613,5775,3343,8054,3283,7557,3120,497,862,285,639,212,581,364,686,1889,2059,17845,5513,4980,3121,7874,3193,7154,3027,720,1004,239,595,481,823,2470,2002,2521,1810
72067,13827,3157,6276,1978,2442,1343,2751,1054,2243,922,508,529,290,397,218,330,265,286,818,661,7551,1756,2209,1015,2542,973,2024,853,518,471,237,301,281,380,1174,646,1626,814
72069,44522,14247,20730,7952,8386,5125,8700,4047,7800,3579,900,1428,322,818,578,1138,928,1269,2716,2557,23792,8510,8716,5324,9514,4201,7954,3644,1560,1899,661,1008,899,1488,2209,2195,3353,2791
72071,35462,9939,17058,5581,7459,4068,7287,2962,6582,2771,705,1003,325,696,380,782,643,908,1669,1622,18404,6016,5703,3648,7651,3128,6560,2815,1091,1292,522,820,569,909,2076,1715,2974,2211
72073,11921,3473,6056,2171,3056,1519,2066,930,1904,852,162,269,94,224,68,175,258,319,676,635,5865,1801,2074,1201,2440,1047,2155,994,285,378,233,348,52,178,630,564,721,656
72075,38014,9964,17820,5715,7994,3912,6938,2710,6307,2523,631,922,346,711,285,691,547,883,2341,1857,20194,5889,7576,3827,8178,3151,7200,2887,978,1186,735,1012,243,657,2044,1614,2396,1773
72077,32078,9918,15060,5822,6805,4139,5272,2661,4661,2350,611,936,231,530,380,762,660,877,2323,2108,17018,5900,6765,4033,6011,2794,4699,2329,1312,1383,550,789,762,1154,1402,1527,2840,2036
72079,19538,6394,9398,3713,4350,2661,3575,1749,3212,1645,363,590,214,437,149,410,300,445,1173,1145,10140,3714,3701,2465,3832,1835,3247,1624,585,761,368,581,217,493,1427,1049,1180,1062
72081,21745,4861,10598,2859,3962,1914,5464,1787,5097,1737,367,498,197,402,170,341,152,298,1020,823,11147,2741,3155,1624,5433,1771,5001,1706,432,509,236,400,196,379,1294,865,1265,916
72083,6941,1812,3432,1027,1370,753,1539,566,1432,546,107,161,66,152,41,109,115,173,408,319,3509,1052,1076,616,1632,646,1403,554,229,305,175,270,54,135,306,263,495,359
72085,31362,7983,14810,4506,6237,3177,6222,2387,5860,2210,362,622,147,361,215,490,497,657,1854,1437,16552,4707,5542,2758,6739,2555,5776,2230,963,1064,406,586,557,821,1449,1247,2822,1929
72087,21389,5483,9784,3134,4816,2315,3589,1609,2911,1338,678,770,500,679,178,429,225,460,1154,919,11605,3297,5100,2302,3736,1558,2870,1330,866,750,568,643,298,490,1021,815,1748,1085
72089,15404,4080,7151,2361,2943,1654,3031,1224,2809,1182,222,364,141,312,81,263,227,354,950,708,8253,2333,2882,1474,3130,1282,2821,1204,309,429,152,318,157,358,767,642,1474,889
72091,32582,8529,15056,4828,6139,3444,6358,2614,5833,2456,525,808,297,686,228,571,614,814,1945,1468,17526,4868,5750,2969,6633,2681,5760,2447,873,1030,486,778,387,710,2173,1703,2970,1797
72093,5133,1274,2537,783,1194,565,909,399,668,315,241,235,128,174,113,145,201,218,233,215,2596,783,1114,576,718,310,679,305,39,78,30,72,9,70,327,223,437,339
72095,9086,3024,4369,1829,2068,1230,1647,848,1567,815,80,210,4,147,76,210,267,332,387,451,4717,1662,1823,1148,1673,815,1543,776,130,275,31,175,99,253,650,594,571,545
72097,64783,18253,30525,11084,14105,7890,11524,5262,10093,4753,1431,1986,818,1573,613,1382,1156,1684,3740,3247,34258,11065,13013,7378,10972,4880,9282,4361,1690,2197,1078,1722,612,1450,4614,3173,5659,3771
72099,30203,7461,14589,4353,5972,3110,7206,2351,6597,2256,609,788,194,424,415,659,264,488,1147,999,15614,4348,4695,2602,7323,2456,6330,2218,993,990,650,800,343,592,1419,1224,2177,1541
72101,25709,6432,12661,3694,5796,2739,4873,1786,4272,1642,601,703,241,424,360,555,327,427,1665,1179,13048,3883,5311,2801,5017,1845,4503,1746,514,617,182,303,332,531,1135,923,1585,1014
72103,21362,7999,9840,4205,4071,2763,3846,2234,3394,1978,452,711,324,586,128,349,396,707,1527,1364,11522,5083,4897,3314,3658,2201,3064,1837,594,919,433,748,161,436,1500,1398,1467,1328
72105,23512,7041,11487,4065,5728,3028,4617,1921,4268,1808,349,474,134,308,215,396,346,454,796,850,12025,3955,4938,2733,4615,1904,3974,1704,641,750,377,531,264,480,1164,959,1308,1017
72107,17400,4517,8629,2720,4419,2136,3230,1299,2884,1199,346,506,154,347,192,407,237,362,743,690,8771,2619,3835,1952,3120,1248,2778,1172,342,454,178,355,164,351,964,658,852,730
72109,14379,4271,6927,2459,3045,1787,2728,1216,2443,1166,285,410,164,329,121,306,238,386,916,860,7452,2543,2724,1661,2955,1346,2485,1189,470,600,171,337,299,494,813,734,960,872
72111,16587,4035,7975,2354,3457,1618,3421,1270,3122,1215,299,431,164,361,135,292,312,400,785,636,8612,2423,3262,1590,3390,1320,2852,1140,538,568,303,420,235,387,654,628,1306,823
72113,116959,32245,55511,18988,26595,14063,20885,9245,18416,8466,2469,3429,1482,2826,987,2433,1951,3076,6080,5469,61448,18844,24138,12842,20887,9017,17795,8052,3092,3904,1950,3098,1142,2718,7540,5734,8883,6336
72115,19891,6157,9496,3604,3818,2564,4154,1856,3704,1727,450,677,94,263,356,610,296,464,1228,1085,10395,3704,2872,2058,4494,2101,3864,1788,630,872,207,451,423,628,1282,1147,1747,1264
72117,12090,3692,5773,2175,2142,1317,2683,1300,2232,1084,451,633,367,550,84,215,152,275,796,717,6317,2137,2043,1177,2136,1039,1814,886,322,449,135,283,187,365,825,679,1313,951
72119,42023,12102,19976,7040,8787,4875,7801,3280,6837,2935,964,1295,616,1051,348,753,773,1228,2615,2265,22047,7043,7999,4643,8344,3460,7178,3087,1166,1449,736,1025,430,955,2117,1744,3587,2539
72121,18975,5543,8768,3018,4554,2400,2891,1245,2598,1146,293,389,199,348,94,270,496,558,827,812,10207,3551,3930,2366,3693,1586,3220,1388,473,644,263,469,210,418,1131,860,1453,1130
72123,23264,7243,11081,4148,5615,2977,4055,1995,3508,1832,547,772,266,547,281,571,335,585,1076,1072,12183,4197,5214,2912,4188,2043,3600,1889,588,737,227,482,361,634,1303,1082,1478,1154
72125,26653,7521,12776,4275,5490,2990,5085,2100,4598,1999,487,658,267,492,220,495,545,712,1656,1388,13877,4206,4733,2674,5169,2117,4318,1872,851,931,433,655,418,655,1558,1136,2417,1509
72127,286918,85338,128905,48429,61662,34894,48074,24363,40658,21436,7416,10322,3003,7145,4413,8421,4409,7829,14760,13816,158013,52132,65922,35679,47433,23773,39339,20677,8094,10599,4007,7857,4087,8095,19638,15690,25020,18093
72129,31537,8087,15210,4619,6525,3300,6213,2346,5413,2110,800,919,250,501,550,758,584,744,1888,1422,16327,4803,5982,3247,6154,2340,5501,2150,653,823,286,531,367,629,1884,1333,2307,1463
72131,31343,8965,15061,5173,5908,3570,6880,2832,6350,2696,530,880,264,645,266,579,743,956,1530,1588,16282,5114,5071,3165,7077,2869,6065,2596,1012,1165,555,840,457,782,1809,1484,2325,1764
72133,17910,5377,8547,3225,3864,2269,3079,1515,2582,1256,497,664,216,422,281,519,297,450,1307,1196,9363,3136,4003,2146,3129,1417,2479,1206,650,718,452,588,198,384,877,762,1354,1097
72135,60797,15046,28827,8592,12754,6072,12890,4266,11636,3851,1254,1598,372,827,882,1328,822,1203,2361,2329,31970,9003,12173,6177,13385,4357,11923,3949,1462,1749,812,1204,650,1099,2841,2338,3571,2634
72137,65587,18186,30205,10443,12976,7230,12160,5088,10808,4633,1352,1862,607,1298,745,1425,1375,1889,3694,3098,35382,10822,13341,7193,12273,5070,10638,4545,1635,2113,920,1549,715,1499,3766,2980,6002,3853
72139,55808,13910,25682,7820,10811,5476,11569,4298,10221,3947,1348,1596,641,1145,707,1165,726,1050,2576,2222,30126,8163,10442,5267,11807,4353,10474,4035,1333,1660,827,1242,506,1050,2855,2136,5022,3116
72141,24132,6834,11617,3937,4726,2730,5079,2114,4549,1901,530,720,395,637,135,422,438,633,1374,1222,12515,3987,4218,2429,4680,1906,4210,1751,470,707,319,578,151,464,1627,1189,1990,1589
72143,30722,9387,14537,5148,6454,3684,6413,2553,5843,2377,570,786,323,583,247,560,471,689,1199,1185,16185,5445,5191,3350,7046,2916,6268,2658,778,927,405,682,373,665,1901,1492,2047,1559
72145,43918,11726,20724,6628,8617,4569,9148,3612,8109,3366,1039,1348,529,951,510,985,713,1007,2246,2030,23194,6932,8121,4525,9120,3639,8030,3370,1090,1338,446,863,644,1099,2591,1958,3362,2475
72147,7134,2817,3532,1700,1834,1460,900,672,771,571,129,234,17,117,112,215,162,244,636,752,3602,1716,1702,1357,966,629,841,611,125,227,104,207,21,118,465,414,469,484
72149,18555,4670,8885,2689,4471,2079,3304,1285,2949,1211,355,436,213,369,142,308,314,409,796,656,9670,2685,3924,1789,3728,1476,3108,1283,620,640,359,445,261,433,718,648,1300,882
72151,28351,8784,13535,4957,6278,3523,5024,2614,4525,2366,499,834,235,552,264,614,549,762,1684,1531,14816,5269,5809,3314,4886,2415,4150,2147,736,965,447,756,289,599,1448,1179,2673,1896
72153,29995,8759,14122,4931,6889,3636,5278,2154,4895,1970,383,700,186,552,197,517,487,667,1468,1363,15873,5462,6611,3804,5588,2207,5110,2046,478,742,257,559,221,571,1705,1210,1969,1552
